Auda_of_France	type	Person
John_III_Burgrave_of_Nuremberg	type	Person
Theobald_III_Count_of_Blois	gender	male
Marie_de_Medici	child	Elisabeth_of_France_1602_1644
Charles_II_of_Naples	successor	Margaret_Countess_of_Anjou
Victor_Amadeus_I_Duke_of_Savoy	father	Charles_Emmanuel_I_Duke_of_Savoy
Engeltrude_de_F_zensac	parent	Leuthard_I_of_Paris
Henry_Count_of_Portugal	predecessor	Raymond_of_Burgundy
Henry_IV_of_England	parent	Blanche_of_Lancaster
Simon_I_de_Montfort	parent	Amaury_I_de_Montfort
Robert_III_of_Scotland	predecessor	Robert_II_of_Scotland
Beatrice_of_Savoy	child	Sanchia_of_Provence
Lorenzo_de_Medici	parent	Piero_di_Cosimo_de_Medici
Henry_IV_of_France	hasSpouse	Yes
Margaret_of_Provence	parent	Ramon_Berenguer_IV_Count_of_Provence
Francis_I_Holy_Roman_Emperor	parent	_lisabeth_Charlotte_d_Orl_ans
Marie_Louise_Duchess_of_Parma	child	William_Albert_1st_Prince_of_Montenuovo
Carloman_son_of_Charles_the_Bald	type	Person
Philip_V_of_Spain	parent	Louis_Dauphin_of_France_son_of_Louis_XIV
Albert_I_of_Germany	child	Frederick_the_Fair
Maria_Sophia_of_Neuburg	type	Person
Walter_Stewart_3rd_High_Steward_of_Scotland	successor	Alexander_Stewart_4th_High_Steward_of_Scotland
James_Stewart_5th_High_Steward_of_Scotland	predecessor	Alexander_Stewart_4th_High_Steward_of_Scotland
Ramon_Berenguer_IV_Count_of_Barcelona	parent	Douce_I_Countess_of_Provence
Marie_Louise_Duchess_of_Parma	hasSpouse	Yes
Albert_I_of_Germany	predecessor	Adolf_King_of_the_Romans
John_I_of_Portugal	child	Edward_King_of_Portugal
Albert_I_of_Germany	mother	Gertrude_of_Hohenberg
Maria_Teresa_Felicitas_d_Este	father	Francesco_III_d_Este_Duke_of_Modena
Henry_I_Count_of_Champagne	parent	Matilda_of_Carinthia
Duke_Charles_Louis_Frederick_of_Mecklenburg	type	Person
Violant_of_Bar	mother	Marie_of_France_Duchess_of_Bar
Charles_VII_of_France	father	Charles_VI_of_France
Philip_of_Swabia	type	Person
Philip_II_of_Spain	type	Person
John_II_of_France	child	Isabella_Countess_of_Vertus
Henry_III_of_England	child	Edward_I_of_England
Patrick_Hepburn_3rd_Earl_of_Bothwell	type	Person
William_the_Younger_Duke_of_Brunswic_L_neburg	father	Ernest_I_Duke_of_Brunswic_L_neburg
Geoffrey_Plantagenet_Count_of_Anjou	child	Henry_II_of_England
John_II_Duke_of_Brittany	type	Person
Maria_Beatrice_of_Savoy	mother	Maria_Theresa_of_Austria_Este_Queen_of_Sardinia
Robert_III_of_Scotland	parent	Elizabeth_Mure
Madeleine_of_Valois	type	Person
Blanche_of_Navarre_Queen_of_France	gender	female
Yolanda_Latin_Empress	predecessor	Peter_II_of_Courtenay
Joanna_of_Castile	child	Mary_of_Hungary_governor_of_the_Netherlands
Henrietta_Maria	spouse	Charles_I_of_England
Charles_Count_of_Valois	spouse	Mahaut_of_Ch_tillon
Edward_V_of_England	type	Person
Louis_VIII_of_France	child	Louis_IX_of_France
Jacques_of_Savoy_Count_of_Romont	type	Person
Sophia_Eleonore_of_Saxony	child	Sophia_Eleonore_of_Hesse_Darmstadt
Henry_III_of_France	hasSpouse	Yes
Charles_Emmanuel_I_Duke_of_Savoy	gender	male
Henry_I_Count_of_Champagne	hasSpouse	Yes
Ernest_Augustus_Elector_of_Hanover	successor	George_I_of_Great_Britain
Charles_IX_of_France	type	Person
Blanche_of_Castile	child	Isabelle_of_France_saint
Rixa_of_Werle	type	Person
Marie_Eleonore_of_Cleves	gender	female
Henry_I_Duke_of_Brabant	spouse	Matilda_of_Boulogne_Duchess_of_Brabant
Yaroslav_the_Wise	child	Anastasia_of_Kiev
Maria_Henrietta_of_Naples_and_Sicily	type	Person
Henry_Stuart_Lord_Darnley	father	Matthew_Stewart_4th_Earl_of_Lennox
Eleanor_de_Guzm_n	spouse	Alfonso_XI_of_Castile
Fulk_I_Count_of_Anjou	parent	Ingelger
Jeanne_d_Albret	parent	Henry_II_of_Navarre
Beatriz_Pereira_de_Alvim	spouse	Afonso_I_Duke_of_Braganza
Arnulf_II_Count_of_Flanders	mother	Matilda_of_Saxony_countess_of_Flanders
Margaret_of_Valois	parent	Henry_II_of_France
Richard_II_of_England	predecessor	Edward_III_of_England
Princess_Louise_of_Hesse_Darmstadt_1757_1830	child	Prince_Bernhard_of_Saxe_Weimar_Eisenach_1792_1862
Princess_Marie_Isabelle_of_Orl_ans	father	Antoine_Duke_of_Montpensier
Adolphus_Frederick_II_Duke_of_Mecklenburg_Strelitz	predecessor	Frederick_William_Duke_of_Mecklenburg_Schwerin
Arnulf_I_Count_of_Flanders	gender	male
Rudolph_II_of_Burgundy	successor	Hugh_of_Italy
Louis_IX_of_France	child	Isabella_of_France_Queen_of_Navarre
Brun_I_Count_of_Brunswick	hasSpouse	No
Matilda_of_England_Duchess_of_Saxony	hasSpouse	Yes
Napoleon	successor	Napoleon_II
Elisabeth_of_Meissen	parent	Frederick_II_Margrave_of_Meissen
Catherine_of_Austria_Duchess_of_Calabria	type	Person
Bertha_of_Burgundy	hasSpouse	Yes
Maria_Elisabeth_of_Saxony_1736_1818	type	Person
John_of_Bohemia	spouse	Elizabeth_of_Bohemia_1292_1330
Alexander_Stewart_of_Darnley_died_1404	type	Person
Bertha_of_Burgundy	type	Person
Louis_the_Pious	spouse	Judith_of_Bavaria_died_843
Marie_of_France_Duchess_of_Bar	child	Violant_of_Bar
Ferdinand_Philippe_Duke_of_Orl_ans	mother	Maria_Amalia_of_Naples_and_Sicily
Marie_of_France_Countess_of_Champagne	type	Person
Sophia_of_Minsk	father	Volodar_Glebovich_Prince_of_Minsk
Odo_II_Duke_of_Burgundy	father	Hugh_II_Duke_of_Burgundy
Louis_Dauphin_of_France_son_of_Louis_XIV	hasSpouse	Yes
Charles_IV_Holy_Roman_Emperor	predecessor	Louis_IV_Holy_Roman_Emperor
John_King_of_England	child	Joan_Lady_of_Wales
Philip_I_of_Castile	predecessor	Joanna_of_Castile
Charles_V_of_France	hasSpouse	Yes
Philip_V_of_Spain	successor	Victor_Amadeus_II_of_Sardinia
Matilda_of_B_thune	parent	Robert_VII_Lord_of_B_thune
Sancho_Count_of_Provence	type	Person
Piero_di_Cosimo_de_Medici	mother	Contessina_de_Bardi
Fredericka_of_Saxe_Gotha_Altenburg	type	Person
Gerloc	parent	Rollo
Ren_e_of_Bourbon	type	Person
Elizabeth_Woodville	spouse	Edward_IV_of_England
Matilda_of_T_bingen	type	Person
Margaret_of_Valois_Angoul_me	parent	Louise_of_Savoy
Maria_Luisa_of_Spain	parent	Charles_III_of_Spain
Ferdinand_I_of_Aragon	child	John_II_of_Aragon
Robert_II_Count_of_Dreux	gender	male
Joanna_of_Austria_Grand_Duchess_of_Tuscany	parent	Ferdinand_I_Holy_Roman_Emperor
Edward_I_of_England	child	Edmund_of_Woodstock_1st_Earl_of_Kent
Charles_the_Younger	type	Person
Margaret_of_Geneva	type	Person
Charles_III_of_Spain	gender	male
Ren__II_Duke_of_Lorraine	parent	Frederick_II_Count_of_Vaud_mont
Boso_the_Elder	hasSpouse	No
Mar_a_Isabella_of_Spain	hasSpouse	Yes
Ferdinand_II_of_Aragon	spouse	Isabella_I_of_Castile
Mary_Queen_of_Scots	parent	James_V_of_Scotland
Matthias_I_Duke_of_Lorraine	successor	Simon_II_Duke_of_Lorraine
Almodis_de_la_Marche	spouse	Ramon_Berenguer_I_Count_of_Barcelona
John_I_of_Aragon	type	Person
Philippe_II_Duke_of_Orl_ans	successor	Louis_Duke_of_Orl_ans_1703_1752
Robert_of_Courtenay_Lord_of_Champignelles	type	Person
Henry_III_Duke_of_Brabant	spouse	Adelaide_of_Burgundy_Duchess_of_Brabant
Edmund_I	type	Person
Joan_I_Countess_of_Auvergne	hasSpouse	Yes
Sophia_of_Hanover	type	Person
Gerberga_of_M_con	hasSpouse	No
Eleanor_of_Alburquerque	type	Person
Guy_IV_Count_of_Saint_Pol	spouse	Marie_of_Brittany_Countess_of_Saint_Pol
Amadeus_VIII_Duke_of_Savoy	hasSpouse	No
Francis_I_Holy_Roman_Emperor	type	Person
Mary_of_Avesnes	hasSpouse	Yes
Peter_I_of_Portugal	predecessor	Afonso_IV_of_Portugal
Jeanne_de_Bourbon_Duchess_of_Bourbon	mother	Isabelle_de_Beauvau
Anne_of_Bohemia_and_Hungary	child	Ferdinand_II_Archduke_of_Austria
Princess_Louise_of_Orl_ans	type	Person
Joanna_of_Pfirt	hasSpouse	Yes
Ingegerd_Olofsdotter_of_Sweden	child	Anne_of_Kiev
Gerberga_of_Saxony	spouse	Louis_IV_of_France
Eleanor_of_Provence	type	Person
Baldwin_V_Count_of_Hainaut	type	Person
Albert_Azzo_I_Margrave_of_Milan	spouse	Adela_of_Milan
Caterina_Sforza	type	Person
Vladimir_the_Great	child	Maria_Dobroniega_of_Kiev
Leopold_Duke_of_Lorraine	mother	Eleonore_of_Austria_Queen_of_Poland
Letizia_Bonaparte	child	J_r_me_Bonaparte
Francis_II_Duke_of_Lorraine	parent	Claude_of_France_1547_1575
Stephen_Count_of_Blois	type	Person
Alice_of_Normandy	type	Person
Charles_III_Duke_of_Lorraine	parent	Francis_I_Duke_of_Lorraine
Berengaria_of_Barcelona	hasSpouse	Yes
Bartholomew_de_L_Isle_Bouchard	hasSpouse	No
Matthew_Stewart_2nd_Earl_of_Lennox	type	Person
Bernhard_Count_of_Anhalt	predecessor	Henry_the_Lion
Eleanor_of_Provence	gender	female
Simon_I_Duke_of_Lorraine	father	Theodoric_II_Duke_of_Lorraine
Frederick_II_Count_of_Vaud_mont	mother	Marie_Countess_of_Harcourt
Ercole_III_d_Este_Duke_of_Modena	type	Person
Maria_Amalia_of_Naples_and_Sicily	child	Princess_Cl_mentine_of_Orl_ans
David_Stewart_Earl_of_Moray	type	Person
Ferdinand_I_Holy_Roman_Emperor	child	Archduchess_Margaret_of_Austria_nun
Ermengarde_Countess_of_Maine	gender	female
Archduchess_Maria_Maddalena_of_Austria	type	Person
Piero_the_Unfortunate	parent	Clarice_Orsini
Louis_III_of_France	gender	male
Joan_I_of_Navarre	successor	Louis_X_of_France
Otto_II_Duke_of_Bavaria	spouse	Agnes_of_the_Palatinate
Peter_I_of_Courtenay	type	Person
Joan_I_Countess_of_Auvergne	father	William_XII_Count_of_Auvergne
Frederick_IV_Duke_of_Lorraine	gender	male
Louis_VI_of_France	gender	male
Rudolph_II_of_Burgundy	father	Rudolph_I_of_Burgundy
Maximilian_I_Holy_Roman_Emperor	gender	male
Robert_III_of_Scotland	child	James_I_of_Scotland
James_V_of_Scotland	parent	James_IV_of_Scotland
Charles_III_Duke_of_Lorraine	mother	Christina_of_Denmark
Ferdinand_I_of_Aragon	mother	Eleanor_of_Aragon_Queen_of_Castile
Ernest_Augustus_Elector_of_Hanover	parent	Anna_Eleonore_of_Hesse_Darmstadt
William_Longsword	spouse	Luitgarde_of_Vermandois
Henry_VI_of_England	predecessor	Edward_IV_of_England
Joan_of_Ponthieu_Dame_of_Epernon	type	Person
Berengar_II_of_Italy	father	Adalbert_I_of_Ivrea
Alfonso_Fern_ndez_el_Ni_o	type	Person
Maria_Anna_of_Bavaria_born_1551	parent	Archduchess_Anna_of_Austria
Godfrey_III_Count_of_Louvain	type	Person
Antoine_Count_of_Vaud_mont	gender	male
Robert_III_of_Scotland	father	Robert_II_of_Scotland
Richeza_of_Poland_Queen_of_Sweden	type	Person
Emanuele_Filiberto_Duke_of_Aosta_1731_1735	type	Person
Berenguer_Ramon_I_Count_of_Barcelona	spouse	Guisla_de_Llu__
Adolph_I_Duke_of_Cleves	hasSpouse	Yes
Alfonso_XI_of_Castile	child	Tello_Alfonso
Elisabeth_of_Nuremberg	parent	Frederick_V_Burgrave_of_Nuremberg
Charles_VII_of_France	type	Person
Louis_II_of_Anjou	name	Louis II
Louis_I_of_Anjou	father	John_II_of_France
Louis_Philippe_I	gender	male
Charles_the_Bald	hasSpouse	Yes
Yolande_of_Dreux_Queen_of_Scotland	hasSpouse	Yes
Maredudd_ap_Tudur	type	Person
Marguerite_of_Lorraine	type	Person
Charles_the_Simple	gender	male
Maria_Theresa_of_Spain	mother	Elisabeth_of_France_1602_1644
Maria_Theresa	child	Joseph_II_Holy_Roman_Emperor
Ramon_Borrell_Count_of_Barcelona	hasSpouse	Yes
Sancho_I_of_Portugal	child	Ferdinand_Count_of_Flanders
Princess_Maria_Amalia_of_the_Two_Sicilies_1818_1857	type	Person
Afonso_III_of_Portugal	hasSpouse	Yes
Beatrice_of_Bavaria	type	Person
Charlotte_of_Bourbon_Queen_of_Cyprus	gender	female
Hugh_III_Duke_of_Burgundy	predecessor	Odo_II_Duke_of_Burgundy
Marie_Louise_Duchess_of_Parma	parent	Maria_Theresa_of_Naples_and_Sicily
Berengar_II_of_Italy	successor	Otto_I_Holy_Roman_Emperor
Saint_Margaret_of_Scotland	child	David_I_of_Scotland
Geoffrey_III_Count_of_Anjou	successor	Fulk_IV_Count_of_Anjou
James_IV_of_Scotland	successor	James_V_of_Scotland
Emmanuel_Philibert_Duke_of_Savoy	successor	Charles_Emmanuel_I_Duke_of_Savoy
Anne_of_Austria_Landgravine_of_Thuringia	type	Person
Mary_Tudor_Queen_of_France	gender	female
Maria_Beatrice_of_Savoy	child	Archduke_Ferdinand_Karl_Viktor_of_Austria_Este
Charles_Count_of_Valois	child	Joan_of_Valois_Countess_of_Hainaut
Adelaide_of_Tours	type	Person
Maria_Carolina_of_Austria	parent	Maria_Theresa
Amadeus_IX_Duke_of_Savoy	type	Person
Louis_Duke_of_Burgundy	type	Person
Philippa_of_Hainault	parent	William_I_Count_of_Hainaut
Pepin_the_Short	parent	Charles_Martel
Odo_I_Duke_of_Burgundy	type	Person
Maximilian_II_Holy_Roman_Emperor	parent	Ferdinand_I_Holy_Roman_Emperor
Frederick_I_Duke_of_Lorraine	hasSpouse	Yes
Maria_Carolina_of_Austria	child	Maria_Amalia_of_Naples_and_Sicily
Otto_William_Count_of_Burgundy	spouse	Ermentrude_de_Roucy
Alfonso_VII_of_Le_n_and_Castile	gender	male
Louis_XIV	child	Marie_Anne_de_Bourbon
Eleanor_of_Aragon_Queen_of_Portugal	mother	Eleanor_of_Alburquerque
Ferdinand_I_of_Aragon	child	Eleanor_of_Aragon_Queen_of_Portugal
Mahaut_Countess_of_Artois	mother	Amicie_de_Courtenay
Hermann_II_Count_of_Celje	type	Person
Charles_the_Bald	mother	Judith_of_Bavaria_died_843
Clarice_Orsini	type	Person
Henry_X_Duke_of_Bavaria	type	Person
Mary_of_Hungary_Queen_of_Naples	child	Robert_King_of_Naples
Otto_William_Count_of_Burgundy	hasSpouse	Yes
Eleanor_of_Aragon_Countess_of_Toulouse	type	Person
Peter_II_of_Aragon	father	Alfonso_II_of_Aragon
Baldwin_IV_Count_of_Flanders	mother	Rozala_of_Italy
Rainier_Marquis_of_Montferrat	type	Person
Elisabeth_of_Austria_Duchess_of_Lorraine	hasSpouse	Yes
Maria_Anna_of_Spain	type	Person
Francis_II_Duke_of_Lorraine	child	Nicholas_Francis_Duke_of_Lorraine
Yolande_Duchess_of_Lorraine	hasSpouse	Yes
Robert_III_of_Worms	hasSpouse	Yes
Charles_Count_of_Valois	type	Person
Willa_of_Tuscany	child	Guy_of_Ivrea
Clementia_of_Hungary	parent	Clemence_of_Austria
Ferdinand_I_of_Aragon	name	Ferdinand I
Robert_I_Duke_of_Burgundy	successor	Hugh_I_Duke_of_Burgundy
Maria_of_Aragon_Queen_of_Portugal	child	Lu_s_of_Portugal_Duke_of_Beja
Caroline_of_Ansbach	hasSpouse	Yes
Louis_XII	gender	male
Boso_the_Elder	gender	male
James_I_of_Aragon	successor	Peter_III_of_Aragon
John_Count_of_Chalon	spouse	Hugh_III_Duke_of_Burgundy
Robert_II_Duke_of_Burgundy	father	Hugh_IV_Duke_of_Burgundy
Dirk_III_Count_of_Holland	hasSpouse	No
Charles_Duke_of_Vend_me	father	Francis_Count_of_Vend_me
Princess_Elisabeth_Albertine_of_Saxe_Hildburghausen	mother	Countess_Sophia_Albertine_of_Erbach_Erbach
Princess_Louise_of_Hesse_Darmstadt_1757_1830	father	Louis_IX_Landgrave_of_Hesse_Darmstadt
Hemma	father	Welf_father_of_Judith
Bernard_I_Duke_of_Brunswic_L_neburg	gender	male
Eleanor_of_Provence	spouse	Henry_III_of_England
Charles_X	successor	Louis_Antoine_Duke_of_Angoul_me
Bona_of_Savoy	child	Gian_Galeazzo_Sforza
Louis_IV_of_France	child	Matilda_of_France
Eadhild	spouse	Hugh_the_Great
Odo_I_Count_of_Blois	parent	Luitgarde_of_Vermandois
Marie_Caroline_of_Bourbo_Two_Sicilies_Duchess_of_Berry	hasSpouse	Yes
Christine_of_Hesse	hasSpouse	Yes
Agnes_of_France_Duchess_of_Burgundy	parent	Margaret_of_Provence
Charlotte_of_Bourbon_Queen_of_Cyprus	hasSpouse	Yes
Cosimo_de_Medici	mother	Piccarda_Bueri
Igor_Yaroslavich	type	Person
Robert_I_Count_of_Dreux	parent	Adelaide_of_Maurienne
Joanna_of_Castile	predecessor	Philip_I_of_Castile
Philip_the_Bold	parent	John_II_of_France
Princess_Marie_Isabelle_of_Orl_ans	child	Princess_Louise_of_Orl_ans
Ingegerd_Olofsdotter_of_Sweden	child	Elisiv_of_Kiev
John_of_Montfort	successor	John_IV_Duke_of_Brittany
Adelaide_of_Maurienne	spouse	Louis_VI_of_France
Louis_the_German	hasSpouse	Yes
Peter_of_Castile	type	Person
Marie_Z_phyrine_of_France	type	Person
Eleanor_of_Portugal_Holy_Roman_Empress	hasSpouse	Yes
Louis_Philippe_I	successor	Ferdinand_Philippe_Duke_of_Orl_ans
Princess_Augusta_of_Saxe_Gotha	father	Frederick_II_Duke_of_Saxe_Gotha_Altenburg
Margaret_of_Savoy_Countess_of_Saint_Pol	father	Louis_Duke_of_Savoy
Bertrade_of_Montfort	parent	Simon_I_de_Montfort
Henry_VI_Count_of_Luxembourg	parent	Henry_V_Count_of_Luxembourg
John_the_Fearless	child	Anne_of_Burgundy
Alfonso_XI_of_Castile	predecessor	Ferdinand_IV_of_Castile
Louis_II_Elector_of_Brandenburg	type	Person
John_IV_Marquis_of_Montferrat	spouse	Margaret_of_Savoy_Countess_of_Saint_Pol
Fulk_IV_Count_of_Anjou	child	Fulk_King_of_Jerusalem
Claudine_de_Brosse	hasSpouse	Yes
Carloman_mayor_of_the_palace	successor	Pepin_the_Short
Agnes_of_Rochlitz	spouse	Berthold_Duke_of_Merania
_thelwulf_King_of_Wessex	child	_thelberht_King_of_Wessex
Hemma	successor	Liutgard_of_Saxony_died_885
Henry_the_Fowler	successor	Otto_I_Holy_Roman_Emperor
Maria_of_Aragon_Queen_of_Portugal	parent	Isabella_I_of_Castile
Robert_I_Duke_of_Burgundy	mother	Constance_of_Arles
Maria_Theresa_of_Naples_and_Sicily	type	Person
Berthold_I_of_Istria	parent	Berthold_II_Count_of_Andechs
Louis_XVII	parent	Marie_Antoinette
Anne_of_Austria	mother	Margaret_of_Austria_Queen_of_Spain
George_III	child	Prince_Octavius_of_Great_Britain
Victor_Amadeus_I_Duke_of_Savoy	child	Francis_Hyacinth_Duke_of_Savoy
Hugh_IV_Duke_of_Burgundy	successor	Robert_II_Duke_of_Burgundy
Godfrey_III_Count_of_Louvain	parent	Godfrey_II_Count_of_Louvain
Elisabeth_Farnese	child	Maria_Teresa_Rafaela_of_Spain
Charles_VII_of_France	child	Yolande_of_Valois
John_I_Duke_of_Cleves	type	Person
Louis_Duke_of_Burgundy	name	Louis
James_I_of_Scotland	parent	Robert_III_of_Scotland
Antoine_Duke_of_Lorraine	spouse	Ren_e_of_Bourbon
Berenguer_Ramon_II_Count_of_Barcelona	type	Person
Elizabeth_of_Austria_1436_1505	child	John_I_Albert
John_Stewart_3rd_Earl_of_Lennox	hasSpouse	No
Baldwin_IV_Count_of_Flanders	parent	Arnulf_II_Count_of_Flanders
Fulk_IV_Count_of_Anjou	parent	Ermengarde_of_Anjou_Duchess_of_Burgundy
Margaret_of_Bourbon_1438_1483	hasSpouse	Yes
Charles_Count_of_Angoul_me	hasSpouse	Yes
Mary_of_Guelders	hasSpouse	Yes
Jeanne_de_Bourbon_Duchess_of_Bourbon	spouse	John_II_Duke_of_Bourbon
Conrad_I_of_Burgundy	child	Gisela_of_Burgundy
Yaropolk_I_of_Kiev	predecessor	Vladimir_the_Great
Joan_II_of_Navarre	parent	Louis_X_of_France
Charles_VI_of_France	parent	Charles_V_of_France
Margaret_of_Provence	child	Blanche_of_France_Infanta_of_Castile
Hugh_III_Duke_of_Burgundy	spouse	John_Count_of_Chalon
Werner_I_Count_of_Klettgau	hasSpouse	No
William_Duke_of_J_lich_Cleves_Berg	spouse	Maria_of_Austria_Duchess_of_J_lich_Cleves_Berg
John_of_Gaunt	spouse	Blanche_of_Lancaster
Margaret_Theresa_of_Spain	type	Person
Beatrice_of_England	parent	Eleanor_of_Provence
Maria_Beatrice_d_Este_Duchess_of_Massa	spouse	Ferdinand_Karl_Archduke_of_Austria_Este
Urraca_of_Le_n	spouse	Raymond_of_Burgundy
Beatrice_of_Savoy	child	Eleanor_of_Provence
Henry_I_of_Navarre	father	Theobald_I_of_Navarre
Elisabeth_of_Swabia	type	Person
John_IV_Duke_of_Brittany	predecessor	John_of_Gaunt
Blanche_II_of_Navarre	type	Person
Charles_II_of_England	type	Person
Adolphus_Frederick_III_Duke_of_Mecklenburg_Strelitz	type	Person
Charles_IV_of_France	parent	Joan_I_of_Navarre
Henry_II_Duke_of_Austria	type	Person
Polyxena_of_Hesse_Rotenburg	hasSpouse	Yes
Ebalus_Duke_of_Aquitaine	hasSpouse	No
Humbert_II_Count_of_Savoy	successor	Amadeus_III_Count_of_Savoy
Henry_V_of_England	gender	male
Charlemagne	name	Charlemagne
Constance_of_Arles	type	Person
Louis_Philippe_I	hasSpouse	Yes
Charles_V_of_France	type	Person
Raymond_of_Burgundy	gender	male
Theobald_II_Count_of_Champagne	parent	Stephen_Count_of_Blois
Marie_Countess_of_Ponthieu	type	Person
Agnes_of_Rochlitz	hasSpouse	Yes
John_II_of_Aragon	child	Blanche_II_of_Navarre
Remigius_of_Rouen	type	Person
John_Constable_of_Portugal	hasSpouse	Yes
Alfonso_II_of_Aragon	type	Person
Louis_Philippe_II_Duke_of_Orl_ans	predecessor	Louis_Philippe_I_Duke_of_Orl_ans
John_VIII_Count_of_Vend_me	type	Person
Margaret_I_Countess_of_Burgundy	type	Person
Alfonso_II_Count_of_Provence	hasSpouse	Yes
Joan_Beaufort_Queen_of_Scots	gender	female
Henry_V_Count_of_Luxembourg	hasSpouse	No
Pepin_of_Herstal	parent	Ansegisel
Baldwin_V_Count_of_Hainaut	parent	Alice_of_Namur
Louis_Duke_of_Savoy	name	Louis
Thomas_Count_of_Savoy	type	Person
James_V_of_Scotland	gender	male
Reginar_II_Count_of_Hainaut	gender	male
Ferdinand_I_of_the_Two_Sicilies	successor	Francis_I_of_the_Two_Sicilies
Louis_Philippe_II_Duke_of_Orl_ans	child	Antoine_Philippe_Duke_of_Montpensier
Henry_the_Lion	child	William_of_Winchester_Lord_of_Lunenburg
Matilda_of_France	type	Person
Louis_IX_of_France	parent	Blanche_of_Castile
Empress_Jos_phine	hasSpouse	Yes
Henry_III_Duke_of_Brabant	type	Person
Louis_XVIII	spouse	Marie_Jos_phine_of_Savoy
Louis_V_of_France	type	Person
Lothair_II_of_Italy	predecessor	Hugh_of_Italy
Richeza_of_Poland_Queen_of_Sweden	child	Sophia_of_Minsk
Margaret_of_England	type	Person
Louise__lisabeth_of_France	child	Princess_Isabella_of_Parma
Ren__II_Duke_of_Lorraine	gender	male
Philippine__lisabeth_d_Orl_ans	type	Person
Mar_a_Isabella_of_Spain	child	Ferdinand_II_of_the_Two_Sicilies
Rotrude_of_Hesbaye	hasSpouse	Yes
Ramon_Berenguer_IV_Count_of_Barcelona	successor	Alfonso_II_of_Aragon
William_X_Duke_of_Aquitaine	gender	male
Elisabeth_of_Meissen	mother	Matilda_of_Bavaria_Margravine_of_Meissen
Alfonso_II_of_Aragon	gender	male
Anne_of_Bohemia_and_Hungary	child	Charles_II_Archduke_of_Austria
Beatrice_of_Brandenburg	hasSpouse	Yes
Maria_Christina_of_the_Two_Sicilies	mother	Mar_a_Isabella_of_Spain
Elizabeth_of_York	child	Mary_Tudor_Queen_of_France
James_I_of_Aragon	name	James I
Charles_III_Duke_of_Savoy	type	Person
John_III_Duke_of_Brittany	type	Person
Ferdinand_Duke_of_Viseu	child	Manuel_I_of_Portugal
Philip_Duke_of_Parma	spouse	Louise__lisabeth_of_France
Yaroslav_the_Wise	child	Vyacheslav_Yaroslavich
Princess_Cl_mentine_of_Orl_ans	type	Person
Galeazzo_Maria_Sforza	parent	Bianca_Maria_Visconti
Louis_II_Duke_of_Bavaria	type	Person
Rurik	gender	male
Henry_I_Count_of_Berg	type	Person
Teresa_Louren_o	hasSpouse	Yes
Odo_I_Count_of_Blois	parent	Theobald_I_Count_of_Blois
Louis_Count_of_Vend_me	parent	John_I_Count_of_La_Marche
Duchess_Helene_of_Mecklenburg_Schwerin	type	Person
Ernest_Augustus_Elector_of_Hanover	spouse	Sophia_of_Hanover
Stephen_III_Duke_of_Bavaria	parent	Elisabeth_of_Sicily_Duchess_of_Bavaria
John_Stewart_3rd_Earl_of_Lennox	type	Person
Joan_III_Countess_of_Burgundy	type	Person
George_Duke_of_Saxony	spouse	Barbara_Jagiellon
Hugh_of_Italy	father	Theobald_of_Arles
Duke_Ernest_Gottlob_of_Mecklenburg	type	Person
Ferdinand_I_Holy_Roman_Emperor	hasSpouse	Yes
Saint_Margaret_of_Scotland	child	Ethelred_of_Scotland
Charles_V_Holy_Roman_Emperor	gender	male
Edward_IV_of_England	type	Person
John_I_of_Portugal	successor	Edward_King_of_Portugal
Bertha_of_Burgundy	spouse	Robert_II_of_France
Philip_I_of_France	successor	Louis_VI_of_France
Louis_Duke_of_Savoy	predecessor	Amadeus_VIII_Duke_of_Savoy
Theobald_I_Count_of_Blois	spouse	Luitgarde_of_Vermandois
William_the_Younger_Duke_of_Brunswic_L_neburg	child	Dorothea_of_Brunswic_L_neburg
Countess_Sophia_Albertine_of_Erbach_Erbach	gender	female
Princess_Caroline_Louise_of_Saxe_Weimar_Eisenach	parent	Princess_Louise_of_Hesse_Darmstadt_1757_1830
Charlotte_of_Bourbon_Queen_of_Cyprus	parent	John_I_Count_of_La_Marche
Anne_of_Foix_Candale	gender	female
Anne_of_Austria_Queen_of_Poland	type	Person
Charles_IV_of_France	predecessor	Philip_V_of_France
Robert_II_Duke_of_Burgundy	child	Louis_of_Burgundy
Charles_III_of_Spain	successor	Charles_VI_Holy_Roman_Emperor
Baldwin_II_Count_of_Hainaut	parent	Richilde_Countess_of_Hainaut
Juana_Enr_quez	hasSpouse	Yes
Afonso_IV_of_Portugal	parent	Denis_of_Portugal
Isabella_I_of_Castile	hasSpouse	Yes
Alfonso_IX_of_Le_n	child	Ferdinand_III_of_Castile
Drogo_of_Champagne	type	Person
John_of_Charolais	type	Person
Baldwin_III_Count_of_Flanders	parent	Adele_of_Vermandois
Countess_Palatine_Dorothea_Sophie_of_Neuburg	parent	Landgravine_Elisabeth_Amalie_of_Hesse_Darmstadt
Francis_II_of_France	gender	male
Karl_August_Grand_Duke_of_Saxe_Weimar_Eisenach	hasSpouse	Yes
Francesco_I_de_Medici_Grand_Duke_of_Tuscany	hasSpouse	Yes
John_Frederick_Duke_of_Brunswic_Calenberg	hasSpouse	Yes
Louis_II_of_Anjou	spouse	John_I_of_Aragon
Wilhelmine_Amalie_of_Brunswick	child	Maria_Amalia_Holy_Roman_Empress
Victor_Amadeus_II_of_Sardinia	child	Maria_Luisa_Gabriella_of_Savoy
Arthur_II_Duke_of_Brittany	successor	John_III_Duke_of_Brittany
Elisabeth_Farnese	spouse	Philip_V_of_Spain
Peter_I_Duke_of_Brittany	successor	John_I_Duke_of_Brittany
Maria_Luisa_of_Spain	hasSpouse	Yes
John_I_of_Castile	mother	Juana_Manuel
Simon_I_de_Montfort	type	Person
Lucia_Migliaccio	type	Person
Margaret_Stewart_born_c._1455	type	Person
Louis_Duke_of_Savoy	successor	Amadeus_IX_Duke_of_Savoy
Ferdinand_III_of_Castile	child	Eleanor_of_Castile
Blanche_of_Navarre_Queen_of_France	father	Philip_III_of_Navarre
Yaroslav_the_Wise	hasSpouse	Yes
Anna_Maria_of_Ostfriesland	gender	female
Anne_of_Brittany	spouse	Louis_XII
John_Stewart_of_Darnley	gender	male
Adela_of_France	type	Person
Agnes_of_Burgundy_Duchess_of_Bourbon	parent	John_the_Fearless
Matilda_of_France	child	Gerberga_of_Burgundy
Manuel_I_of_Portugal	hasSpouse	Yes
Jeanne_d_Albret	type	Person
Margaret_of_Geneva	parent	William_I_of_Geneva
Philippe_I_Duke_of_Orl_ans	parent	Anne_of_Austria
Frederick_IV_Duke_of_Lorraine	spouse	Elisabeth_of_Austria_Duchess_of_Lorraine
Berengaria_of_Le_n	type	Person
Hugh_II_Duke_of_Burgundy	parent	Sibylla_of_Burgundy_Duchess_of_Burgundy
Maria_of_Austria_Duchess_of_J_lich_Cleves_Berg	hasSpouse	Yes
Eleanor_of_Alburquerque	father	Sancho_Alfonso
Adelaide_of_Burgundy_Duchess_of_Brabant	hasSpouse	Yes
Francis_Hyacinth_Duke_of_Savoy	successor	Charles_Emmanuel_II_Duke_of_Savoy
Saint_Margaret_of_Scotland	type	Person
Adela_of_France	hasSpouse	Yes
Estrid_of_the_Obotrites	spouse	Olof_Sk_tkonung
Henry_I_of_Navarre	parent	Theobald_I_of_Navarre
Alessandro_de_Medici_Duke_of_Florence	successor	Cosimo_I_de_Medici_Grand_Duke_of_Tuscany
George_II_of_Great_Britain	child	Princess_Amelia_of_Great_Britain
Matilda_of_Boulogne_Duchess_of_Brabant	spouse	Henry_I_Duke_of_Brabant
Rudolph_I_of_Burgundy	spouse	Guilla_of_Provence
Rudolf_I_of_Germany	father	Albert_IV_Count_of_Habsburg
Robert_I_Count_of_Dreux	gender	male
Maria_of_Swabia	type	Person
Adela_of_France	spouse	Baldwin_V_Count_of_Flanders
Frederuna	gender	female
Philippa_of_Hainault	hasSpouse	Yes
James_I_of_Scotland	hasSpouse	Yes
Charles_Duke_of_Orl_ans	parent	Louis_I_Duke_of_Orl_ans
Eug_nie_de_Montijo	hasSpouse	Yes
Archduchess_Maria_Theresa_of_Austria_Este_1817_1886	parent	Francis_IV_Duke_of_Modena
Sancho_I_of_Portugal	hasSpouse	Yes
John_II_of_Portugal	mother	Isabel_of_Coimbra
Fulk_IV_Count_of_Anjou	gender	male
Ferdinand_IV_of_Castile	gender	male
Pepin_the_Short	predecessor	Charles_Martel
Frederick_II_Duke_of_Saxe_Gotha_Altenburg	type	Person
Berengar_I_of_Italy	predecessor	Charles_the_Fat
Hemma	predecessor	Judith_of_Bavaria_died_843
Pepin_the_Short	type	Person
Henry_III_Duke_of_Brabant	parent	Maria_of_Swabia
Louis_I_Duke_of_Bar	type	Person
Louis_Count_of_Vend_me	gender	male
Maria_Josepha_of_Austria	father	Joseph_I_Holy_Roman_Emperor
Clotilde_of_France	type	Person
Hugh_of_Italy	predecessor	Rudolph_II_of_Burgundy
Vincent_de_Bourbon_Count_of_Guingamp	type	Person
Napoleon_III	mother	Hortense_de_Beauharnais
Countess_Sophia_Albertine_of_Erbach_Erbach	type	Person
Frederick_III_Holy_Roman_Emperor	parent	Cymburgis_of_Masovia
Letizia_Bonaparte	child	Pauline_Bonaparte
Margaret_of_Austria_Queen_of_Spain	hasSpouse	Yes
Maria_of_Montpellier	spouse	Peter_II_of_Aragon
Lothair_II_of_Italy	gender	male
Francis_I_Holy_Roman_Emperor	predecessor	Charles_VII_Holy_Roman_Emperor
Maria_Antonia_Ferdinanda_of_Spain	mother	Elisabeth_Farnese
Arthur_II_Duke_of_Brittany	hasSpouse	Yes
Valdemar_II_of_Denmark	type	Person
Floris_I_Count_of_Holland	parent	Dirk_III_Count_of_Holland
Peter_I_of_Portugal	spouse	In_s_de_Castro
Philip_I_of_France	type	Person
Joanna_of_Bourbon	mother	Isabella_of_Valois_Duchess_of_Bourbon
Margaret_Holland_Duchess_of_Clarence	parent	Alice_Holland_Countess_of_Kent
Jeanne_de_Laval	spouse	Ren__of_Anjou
Isabella_Countess_of_Gloucester	spouse	John_King_of_England
George_III	hasSpouse	Yes
Frederick_III_Duke_of_Lorraine	predecessor	Matthias_II_Duke_of_Lorraine
John_FitzAlan_1st_Baron_Arundel	type	Person
Baldwin_III_Count_of_Flanders	parent	Arnulf_I_Count_of_Flanders
Louis_Antoine_Duke_of_Angoul_me	predecessor	Charles_X
Anna_of_Holstei_Gottorp	parent	Adolf_Duke_of_Holstei_Gottorp
Leopold_III_Duke_of_Austria	parent	Joanna_of_Pfirt
Elisabeth_of_Austria_Queen_of_France	spouse	Charles_IX_of_France
Sverker_I_of_Sweden	type	Person
Otto_IV_Count_of_Burgundy	successor	Joan_II_Countess_of_Burgundy
Alexander_Stewart_Earl_of_Buchan	type	Person
Hugh_Magnus	hasSpouse	No
Empress_Matilda	child	Henry_II_of_England
Bona_of_Savoy	type	Person
Countess_Palatine_Dorothea_Sophie_of_Neuburg	spouse	Francesco_Farnese_Duke_of_Parma
John_of_Gaunt	successor	John_IV_Duke_of_Brittany
John_I_of_France	type	Person
Louis_IV_Holy_Roman_Emperor	child	Louis_V_Duke_of_Bavaria
Henry_VI_Count_of_Luxembourg	gender	male
Pepin_the_Short	gender	male
Maria_Antonia_Ferdinanda_of_Spain	child	Prince_Maurizio_Duke_of_Montferrat
Charles_the_Bald	gender	male
Anne_of_Foix_Candale	father	Gaston_de_Foix_Count_of_Candale
Odoardo_Farnese_Hereditary_Prince_of_Parma	type	Person
Gaston_IV_Count_of_Foix	hasSpouse	Yes
Stephen_III_of_Auxonne	gender	male
Louis_X_of_France	spouse	Margaret_of_Burgundy_Queen_of_France
Odoardo_Farnese_Hereditary_Prince_of_Parma	spouse	Countess_Palatine_Dorothea_Sophie_of_Neuburg
Margaret_of_Anjou	type	Person
Charles_Duke_of_Vend_me	child	Louis_Prince_of_Cond__1530_1569
Cosimo_I_de_Medici_Grand_Duke_of_Tuscany	child	Portrait_of_Bia_de_Medici
Louis_VII_of_France	spouse	Eleanor_of_Aquitaine
Baldwin_VI_Count_of_Flanders	parent	Adela_of_France
Constance_of_Arles	gender	female
John_IV_Duke_of_Brittany	spouse	Mary_of_Waltham
Peter_I_Duke_of_Bourbon	mother	Mary_of_Avesnes
Robert_II_of_France	child	Henry_I_of_France
Ferdinand_II_of_Aragon	predecessor	Isabella_I_of_Castile
Henry_son_of_Robert_I_of_Burgundy	mother	Helie_of_Semur
Afonso_II_of_Portugal	father	Sancho_I_of_Portugal
Henry_II_of_France	father	Francis_I_of_France
Anne_of_Brittany	spouse	Maximilian_I_Holy_Roman_Emperor
Cymburgis_of_Masovia	hasSpouse	Yes
Antoinette_of_Bourbon	child	Francis_Duke_of_Guise
Maria_Anna_of_Bavaria_born_1551	mother	Archduchess_Anna_of_Austria
Sancho_I_of_Portugal	child	Peter_I_Count_of_Urgell
Sudislav	type	Person
Yolande_of_Dreux_Duchess_of_Burgundy	gender	female
Louis_II_Duke_of_Bavaria	spouse	Matilda_of_Habsburg
Louis_Count_of__vreux	hasSpouse	Yes
Margaret_of_Burgundy_Queen_of_France	mother	Agnes_of_France_Duchess_of_Burgundy
George_I_of_Great_Britain	gender	male
James_II_of_Scotland	successor	James_III_of_Scotland
Alfonso_VIII_of_Castile	type	Person
Liudolf_Duke_of_Saxony	type	Person
Albert_II_Duke_of_Austria	type	Person
Maria_Theresa_of_Spain	child	Marie_Th_r_se_of_France_1667_1672
Maria_Theresa_of_Naples_and_Sicily	child	Archduke_Franz_Karl_of_Austria
John_IV_Duke_of_Brittany	child	Marie_of_Brittany_Lady_of_La_Guerche
John_of_Gaunt	child	Henry_IV_of_England
Beatrice_of_Silesia	spouse	Louis_IV_Holy_Roman_Emperor
Lucrezia_Tornabuoni	type	Person
Adelaide_Blanche_of_Anjou	hasSpouse	Yes
Reginar_III_Count_of_Hainaut	parent	Adelaide_of_Burgundy_born_c._896
Maria_Amalia_of_Naples_and_Sicily	parent	Ferdinand_I_of_the_Two_Sicilies
Isabella_of_Aragon_Queen_of_France	parent	James_I_of_Aragon
Albert_IV_Count_of_Habsburg	gender	male
Helena_of_Denmark	type	Person
Frederick_II_Duke_of_Lorraine	parent	Frederick_I_Duke_of_Lorraine
Eug_nie_de_Montijo	gender	female
Henry_the_Fowler	type	Person
Alfonso_VII_of_Le_n_and_Castile	child	Sancha_of_Castile_Queen_of_Aragon
Louis_I_Duke_of_Bourbon	gender	male
Afonso_I_of_Portugal	parent	Theresa_Countess_of_Portugal
Albert_Azzo_II_Margrave_of_Milan	type	Person
Godfrey_II_Count_of_Louvain	gender	male
Magnus_I_Duke_of_Brunswic_L_neburg	type	Person
Victor_Amadeus_II_of_Sardinia	type	Person
Agnes_of_Burgundy_Duchess_of_Bourbon	child	Peter_II_Duke_of_Bourbon
Magnus_I_Duke_of_Brunswic_L_neburg	mother	Rixa_of_Werle
Charles_Duke_of_Orl_ans	child	Louis_XII
Maria_Anna_of_Savoy	type	Person
Francesco_I_de_Medici_Grand_Duke_of_Tuscany	child	Marie_de_Medici
Louis_Philippe_I_Duke_of_Orl_ans	spouse	Louise_Henriette_de_Bourbon
Philip_the_Good	predecessor	John_the_Fearless
Matilda_of_Habsburg	spouse	Louis_II_Duke_of_Bavaria
Isabella_of_Valois_Duchess_of_Bourbon	parent	Mahaut_of_Ch_tillon
Philippe_I_Duke_of_Orl_ans	child	Philippe_II_Duke_of_Orl_ans
Maud_Chaworth	type	Person
Francis_IV_Duke_of_Modena	mother	Maria_Beatrice_d_Este_Duchess_of_Massa
Henry_IV_of_England	hasSpouse	Yes
Rozala_of_Italy	spouse	Robert_II_of_France
Edward_I_of_England	parent	Eleanor_of_Provence
Charles_VI_of_France	child	Joan_of_France_Duchess_of_Brittany
Louis_IX_Landgrave_of_Hesse_Darmstadt	spouse	Countess_Palatine_Caroline_of_Zweibr_cken
Elisabeth_of_Austria_Queen_of_France	hasSpouse	Yes
Joan_Countess_of_Ponthieu	hasSpouse	Yes
Leopold_III_Duke_of_Austria	spouse	Viridis_Visconti
Maria_Antonia_Ferdinanda_of_Spain	parent	Philip_V_of_Spain
Louise_of_Savoy	father	Philip_II_Duke_of_Savoy
Adolphus_Frederick_I_Duke_of_Mecklenburg_Schwerin	gender	male
Louis_VIII_of_France	predecessor	John_King_of_England
Margaret_of_Austria_Queen_of_Spain	gender	female
Alfonso_VII_of_Le_n_and_Castile	parent	Urraca_of_Le_n
Robert_II_of_France	spouse	Rozala_of_Italy
Ernest_Augustus_Elector_of_Hanover	predecessor	John_Frederick_Duke_of_Brunswic_Calenberg
Albert_III_Count_of_Habsburg	gender	male
Louis_I_of_Anjou	hasSpouse	Yes
Rixa_of_Werle	spouse	Albert_II_Duke_of_Brunswic_L_neburg
Eleanor_of_Lancaster	child	Thomas_Arundel
Bernard_II_Duke_of_Saxony	hasSpouse	No
Mary_of_Guise	father	Claude_Duke_of_Guise
Claude_Fran_oise_de_Lorraine	spouse	Nicholas_Francis_Duke_of_Lorraine
Hedwig_of_Saxony	hasSpouse	Yes
Napoleon_II	gender	male
Enno_III_Count_of_East_Frisia	type	Person
Guilla_of_Provence	spouse	Rudolph_I_of_Burgundy
Adelaide_of_Tours	child	Robert_I_of_France
Antoine_Duke_of_Montpensier	parent	Maria_Amalia_of_Naples_and_Sicily
Charles_Ferdinand_Duke_of_Berry	hasSpouse	Yes
Otto_V_Duke_of_Brunswic_L_neburg	gender	male
Joanna_of_Austria_Grand_Duchess_of_Tuscany	gender	female
Odo_of_France	mother	Adelaide_of_Tours
Louis_II_of_Hungary	type	Person
Francis_Duke_of_Anjou	parent	Catherine_de_Medici
Antoine_Duke_of_Lorraine	predecessor	Ren__II_Duke_of_Lorraine
Charles_II_Duke_of_Bourbon	type	Person
Countess_Palatine_Dorothea_Sophie_of_Neuburg	type	Person
Margaret_of_Bourbon_1438_1483	type	Person
Henry_V_Count_of_Luxembourg	type	Person
Joan_Countess_of_Ponthieu	type	Person
Eugene_Jean_Count_of_Soissons	type	Person
William_III_of_M_con	type	Person
Baldwin_IV_Count_of_Flanders	gender	male
Louis_I_Duke_of_Orl_ans	parent	Joanna_of_Bourbon
Albert_I_Duke_of_Brunswic_L_neburg	mother	Matilda_of_Brandenburg_Duchess_of_Brunswic_L_neburg
Blanche_of_Artois	spouse	Edmund_Crouchback
Henry_IV_of_France	child	Nicolas_Henri_Duke_of_Orl_ans
Thomas_Francis_Prince_of_Carignano	type	Person
Jacquetta_of_Luxembourg	parent	Margaret_of_Baux
Frederick_III_Holy_Roman_Emperor	name	Frederick III
Charles_Martel	spouse	Rotrude_of_Hesbaye
Louis_II_of_Italy	type	Person
Elisabeth_of_Austria_Queen_of_France	father	Maximilian_II_Holy_Roman_Emperor
Louis_Bonaparte	type	Person
Beatrice_of_Vermandois	hasSpouse	Yes
William_IV_Duke_of_Aquitaine	mother	Gerloc
Francis_II_Holy_Roman_Emperor	child	Marie_Louise_Duchess_of_Parma
John_II_Duke_of_Brittany	gender	male
Aimery_I_Viscount_of_Ch_tellerault	hasSpouse	Yes
Bonne_of_Berry	type	Person
Antonio_Farnese_Duke_of_Parma	successor	Charles_III_of_Spain
Marie_Eleonore_of_Cleves	father	William_Duke_of_J_lich_Cleves_Berg
Gertrude_of_Saxony	gender	female
Edward_I_of_England	mother	Eleanor_of_Provence
Ermengarde_of_Hesbaye	father	Ingerman_Count_of_Hesbaye
Cosimo_I_de_Medici_Grand_Duke_of_Tuscany	father	Giovanni_delle_Bande_Nere
Welf_I_Duke_of_Bavaria	mother	Kunigunde_of_Altdorf
Lothair_of_France	parent	Louis_IV_of_France
Madame_Ad_la_de	type	Person
Princess_Augusta_of_Saxe_Gotha	parent	Frederick_II_Duke_of_Saxe_Gotha_Altenburg
Maria_Amalia_of_Naples_and_Sicily	child	Fran_ois_d_Orl_ans_Prince_of_Joinville
Judith_of_Habsburg	father	Rudolf_I_of_Germany
Matilda_of_Scotland	child	William_Adelin
Maria_Christina_of_the_Two_Sicilies	gender	female
Archduke_Alexander_Leopold_of_Austria	type	Person
Maria_Josepha_of_Austria	gender	female
Henry_VII_of_England	child	Elizabeth_Tudor_1492_1495
Francis_II_Holy_Roman_Emperor	child	Archduke_Joseph_Franz_of_Austria
Philip_Count_of_Longueville	type	Person
Theobald_I_of_Navarre	gender	male
Arthur_III_Duke_of_Brittany	type	Person
Frederick_IV_Duke_of_Lorraine	parent	Theobald_II_Duke_of_Lorraine
Matthias_I_Duke_of_Lorraine	parent	Adelaide_of_Leuven
Maria_Luisa_of_Spain	child	Archduchess_Maria_Anna_of_Austria_born_1770
Robert_the_Strong	parent	Robert_III_of_Worms
Louis_II_Duke_of_Bavaria	parent	Otto_II_Duke_of_Bavaria
Ferdinand_II_Archduke_of_Austria	predecessor	Ferdinand_I_Holy_Roman_Emperor
Robert_VII_Lord_of_B_thune	hasSpouse	No
Peter_I_Duke_of_Brittany	type	Person
Otto_V_Duke_of_Brunswic_L_neburg	type	Person
Francis_I_Holy_Roman_Emperor	child	Marie_Antoinette
Ferdinand_I_of_Aragon	child	Henry_Duke_of_Villena
Ren__II_Duke_of_Lorraine	child	Claude_Duke_of_Guise
Charles_Emmanuel_II_Duke_of_Savoy	parent	Christine_of_France
Duchess_Helene_of_Mecklenburg_Schwerin	gender	female
Stephen_V_of_Hungary	type	Person
Mary_of_Avesnes	spouse	Louis_I_Duke_of_Bourbon
Cosimo_I_de_Medici_Grand_Duke_of_Tuscany	predecessor	Alessandro_de_Medici_Duke_of_Florence
Victor_Amadeus_III_of_Sardinia	child	Marie_Jos_phine_of_Savoy
Margaret_of_Brabant	child	Marie_of_Luxembourg_Queen_of_France
Frederick_V_Burgrave_of_Nuremberg	spouse	Elisabeth_of_Meissen
Blanche_of_Navarre_Countess_of_Champagne	hasSpouse	Yes
Christine_of_Saxony	child	Philip_II_Landgrave_of_Hesse_Rheinfels
Ferdinand_III_of_Castile	parent	Alfonso_IX_of_Le_n
Ludovico_Sforza	type	Person
Adela_of_Champagne	father	Theobald_II_Count_of_Champagne
Olof_Sk_tkonung	type	Person
Jacquetta_of_Luxembourg	child	Elizabeth_Woodville
Robert_Count_of_Clermont	father	Louis_IX_of_France
Charles_III_Duke_of_Lorraine	successor	Henry_II_Duke_of_Lorraine
Francis_I_Duke_of_Lorraine	parent	Antoine_Duke_of_Lorraine
Duchess_Helene_of_Mecklenburg_Schwerin	child	Prince_Robert_Duke_of_Chartres
Edward_King_of_Portugal	spouse	Eleanor_of_Aragon_Queen_of_Portugal
Eleanor_of_Aragon_Queen_of_Castile	hasSpouse	Yes
Elizabeth_of_Bohemia_1292_1330	parent	Wenceslaus_II_of_Bohemia
Robert_II_Duke_of_Burgundy	gender	male
Theobald_III_Count_of_Champagne	gender	male
Fulk_I_Count_of_Anjou	mother	Adelais_of_Amboise
Amadeus_III_Count_of_Savoy	type	Person
Ferdinand_II_of_Aragon	father	John_II_of_Aragon
French_Revolution_of_1848	predecessor	Louis_Philippe_I
Juana_Enr_quez	spouse	John_II_of_Aragon
Beatrice_of_Portugal	type	Person
Countess_Palatine_Caroline_of_Zweibr_cken	parent	Christian_III_Count_Palatine_of_Zweibr_cken
Adelaide_of_Auxerre_born_c._870	type	Person
Baldwin_III_Count_of_Flanders	mother	Adele_of_Vermandois
Portrait_of_Bia_de_Medici	type	Person
Amaury_I_de_Montfort	type	Person
Poppa_of_Bayeux	hasSpouse	No
Beatrice_of_Castile_Marchioness_of_Montferrat	type	Person
Raymond_of_Burgundy	spouse	Urraca_of_Le_n
Maria_Luisa_of_Spain	child	Ferdinand_III_Grand_Duke_of_Tuscany
Henrietta_of_England	child	Philippe_Charles_Duke_of_Valois
Philip_III_of_Spain	parent	Anna_of_Austria_Queen_of_Spain
Peter_II_Count_of_La_Marche	type	Person
Charles_III_Duke_of_Lorraine	type	Person
Ferdinand_II_of_Le_n	gender	male
Henry_X_Duke_of_Bavaria	spouse	Gertrude_of_S_pplingenburg
John_I_of_Portugal	predecessor	1383_1385_Portuguese_interregnum
Maria_Theresa	type	Person
Prince_Louis_Count_of_Aquila	type	Person
Hugh_Count_of_Burgundy	hasSpouse	Yes
Charles_VI_of_France	predecessor	Charles_V_of_France
Salomea_of_Berg	type	Person
Maria_of_Swabia	gender	female
Beatrice_of_Savoy_Lady_of_Villena	type	Person
Isabella_of_Aragon_Queen_of_France	mother	Violant_of_Hungary
Louis_Dauphin_of_France_son_of_Louis_XV	child	Louis_XVI
Yolande_of_Brittany	type	Person
Marie_de_Medici	mother	Joanna_of_Austria_Grand_Duchess_of_Tuscany
Eleanor_of_Austria	spouse	Manuel_I_of_Portugal
Archduchess_Maria_Carolina_of_Austria_born_1740	type	Person
Marie_of_France_Duchess_of_Brabant	type	Person
Charles_Duke_of_Vend_me	child	John_Count_of_Soissons_and_Enghien
Gerberga_of_M_con	type	Person
Odo_of_France	parent	Robert_the_Strong
Joan_I_of_Navarre	predecessor	Henry_I_of_Navarre
Fran_oise_Ath_na_s_de_Rochechouart_Marquise_de_Montespan	parent	Gabriel_de_Rochechouart_de_Mortemart
Alys_of_France_Countess_of_Vexin	gender	female
Dirk_III_Count_of_Holland	gender	male
Salomea_of_Berg	child	Henry_of_Sandomierz
Philip_I_of_Castile	child	Isabella_of_Austria
Elisabeth_of_Carinthia_Queen_of_the_Romans	spouse	Albert_I_of_Germany
Albert_I_of_Germany	child	Anne_of_Austria_Margravine_of_Brandenburg
Yolande_of_Dreux_Duchess_of_Burgundy	type	Person
_thelberht_King_of_Wessex	type	Person
Francis_Count_of_Vend_me	type	Person
Gerard_Duke_of_Lorraine	father	Gerard_de_Bouzonville
George_II_Landgrave_of_Hesse_Darmstadt	spouse	Sophia_Eleonore_of_Saxony
Werner_II_Count_of_Habsburg	type	Person
Leopold_III_Duke_of_Austria	successor	William_Duke_of_Austria
Henry_VII_of_England	name	Henry VII
Joan_II_Countess_of_Burgundy	successor	Joan_III_Countess_of_Burgundy
Francesco_I_Sforza	parent	Lucia_da_Torsano
Hugh_IV_Duke_of_Burgundy	child	Robert_II_Duke_of_Burgundy
Charlemagne	gender	male
Margaret_of_Brieg	child	John_III_Duke_of_Bavaria
Godfrey_I_Count_of_Louvain	parent	Henry_II_Count_of_Louvain
Joseph_II_Holy_Roman_Emperor	predecessor	Maria_Theresa
Elizabeth_of_Austria_1436_1505	spouse	Casimir_IV_Jagiellon
Philippe_II_Duke_of_Orl_ans	parent	Philippe_I_Duke_of_Orl_ans
Afonso_II_of_Portugal	parent	Dulce_of_Aragon
Sophia_Eleonore_of_Saxony	child	Marie_Hedwig_of_Hesse_Darmstadt
Odo_III_Duke_of_Burgundy	successor	Hugh_IV_Duke_of_Burgundy
Humbert_II_Count_of_Savoy	type	Person
Philip_V_of_France	gender	male
Frederick_IV_Duke_of_Lorraine	father	Theobald_II_Duke_of_Lorraine
Gerard_Duke_of_Lorraine	type	Person
Ferdinand_III_of_Castile	child	Henry_of_Castile_the_Senator
Antoine_Duke_of_Montpensier	name	Antoine
Afonso_II_of_Portugal	mother	Dulce_of_Aragon
Charles_I_of_England	type	Person
Frederick_Duke_of_Bavaria	type	Person
Charlemagne	predecessor	Pepin_the_Short
Joan_of_France_Duchess_of_Berry	spouse	Louis_XII
Philip_IV_of_Spain	gender	male
Henry_I_of_Navarre	name	Henry I
Petronilla_of_Aragon	hasSpouse	Yes
Robert_II_Count_of_Dreux	mother	Agnes_de_Baudemont_Countess_of_Braine
Adela_of_Normandy	spouse	Stephen_Count_of_Blois
Marie_Viscountess_of_Limoges	type	Person
Charles_the_Child	type	Person
Louis_Rudolph_Duke_of_Brunswic_L_neburg	type	Person
James_II_of_Scotland	mother	Joan_Beaufort_Queen_of_Scots
Elizabeth_of_York	child	Henry_VIII
Ramon_Berenguer_IV_Count_of_Provence	predecessor	Alfonso_II_Count_of_Provence
John_I_of_France	name	John I
Wenceslaus_I_Duke_of_Luxembourg	type	Person
Dirk_III_Count_of_Holland	predecessor	Arnulf_Count_of_Holland
Sophia_of_Saxe_Weissenfels_Princess_of_Anhalt_Zerbst	type	Person
Alfonso_XI_of_Castile	parent	Constance_of_Portugal
Gertrude_of_Hohenberg	spouse	Rudolf_I_of_Germany
Mary_Tudor_Queen_of_France	child	Frances_Grey_Duchess_of_Suffolk
Maria_of_Swabia	parent	Irene_Angelina
Ferdinand_III_of_Castile	spouse	Joan_Countess_of_Ponthieu
Yaroslav_the_Wise	child	Elisiv_of_Kiev
Charles_Count_of_Valois	gender	male
Louis_VIII_of_France	gender	male
Charles_the_Simple	spouse	Frederuna
Isabella_Duchess_of_Lorraine	successor	John_II_Duke_of_Lorraine
Richard_Count_of__tampes	type	Person
Afonso_V_of_Portugal	parent	Eleanor_of_Aragon_Queen_of_Portugal
Edward_the_Elder	predecessor	Alfred_the_Great
Philippe_II_Duke_of_Orl_ans	child	Philippine__lisabeth_d_Orl_ans
Adalbert_of_Italy	type	Person
Isabeau_of_Bavaria	hasSpouse	Yes
Alfonso_VIII_of_Castile	gender	male
John_the_Fearless	successor	Philip_the_Good
Henrietta_of_England	father	Charles_I_of_England
Louis_Dauphin_of_France_son_of_Louis_XV	child	Louis_XVIII
Humbert_II_Count_of_Savoy	hasSpouse	Yes
Isabella_of_Angoul_me	hasSpouse	Yes
Maria_Teresa_Felicitas_d_Este	child	Louis_Alexandre_Prince_of_Lamballe
Margaret_of_Valois	hasSpouse	Yes
Marie_of_Brabant_Queen_of_France	parent	Henry_III_Duke_of_Brabant
Elizabeth_Woodville	child	Cecily_of_York
Valdemar_I_of_Denmark	child	Valdemar_II_of_Denmark
Jeanne_de_Laval	type	Person
Louis_the_German	spouse	Hemma
Maria_Teresa_Felicitas_d_Este	gender	female
Agnes_of_the_Palatinate	hasSpouse	Yes
Albrecht_of_Saxe_Weissenfels	type	Person
Philip_II_Duke_of_Savoy	spouse	Claudine_de_Brosse
Louis_IV_of_France	mother	Eadgifu_of_Wessex
Beatrice_of_Savoy	parent	Thomas_Count_of_Savoy
John_King_of_England	parent	Henry_II_of_England
Baldwin_II_of_Jerusalem	type	Person
Charles_V_Duke_of_Lorraine	mother	Claude_Fran_oise_de_Lorraine
Charles_the_Bald	type	Person
Odo_II_Count_of_Blois	parent	Odo_I_Count_of_Blois
Thomas_Stewart_bishop_of_St_Andrews	type	Person
Casimir_IV_Jagiellon	spouse	Elizabeth_of_Austria_1436_1505
Francis_II_Holy_Roman_Emperor	hasSpouse	Yes
John_I_of_France	hasSpouse	No
Maria_Carolina_of_Austria	child	Maria_Anna_of_Naples_and_Sicily
Otto_I_Duke_of_Bavaria	mother	Heilika_of_Lengenfeld
Theobald_I_of_Navarre	child	Henry_I_of_Navarre
Estrid_of_the_Obotrites	child	Ingegerd_Olofsdotter_of_Sweden
Philip_Duke_of_Parma	type	Person
Am_lie_of_Orl_ans	type	Person
Philippe_I_Duke_of_Orl_ans	parent	Louis_XIII
Rurik	successor	Oleg_of_Novgorod
Constanza_Manuel	spouse	Alfonso_XI_of_Castile
Joan_the_Lame	type	Person
Diego_Prince_of_Asturias	type	Person
Adolphus_Frederick_III_Duke_of_Mecklenburg_Strelitz	predecessor	Adolphus_Frederick_II_Duke_of_Mecklenburg_Strelitz
Edmund_of_Woodstock_1st_Earl_of_Kent	type	Person
Beorhtric_of_Wessex	successor	Ecgberht_King_of_Wessex
Louis_Duke_of_Orl_ans_1703_1752	parent	Fran_oise_Marie_de_Bourbon
Garzia_de_Medici	type	Person
Violant_of_Hungary	mother	Yolanda_of_Courtenay
Louis_XII	parent	Charles_Duke_of_Orl_ans
Charles_the_Bald	child	Lothair_the_Lame
Holy_Roman_Emperor	type	Person
Philip_II_of_Spain	spouse	Maria_Manuela_Princess_of_Portugal
Prince_Philippe_Count_of_Paris	type	Person
Gerberga_of_Saxony	parent	Henry_the_Fowler
Sophia_Eleonore_of_Hesse_Darmstadt	type	Person
Adela_of_Champagne	child	Philip_II_of_France
Henry_son_of_Robert_I_of_Burgundy	parent	Robert_I_Duke_of_Burgundy
Adalbert_Duke_of_Lorraine	successor	Gerard_Duke_of_Lorraine
Maria_Anna_of_Bavaria_born_1551	parent	Albert_V_Duke_of_Bavaria
Mary_of_Hungary_Queen_of_Naples	child	John_Duke_of_Durazzo
Henry_I_Duke_of_Burgundy	type	Person
Werner_I_Count_of_Klettgau	gender	male
Yolande_of_Aragon	child	Louis_III_of_Anjou
Henry_II_of_France	child	Claude_of_France_1547_1575
Philip_I_Duke_of_Burgundy	predecessor	Odo_IV_Duke_of_Burgundy
Richard_Duke_of_Burgundy	gender	male
Maria_Antonia_Ferdinanda_of_Spain	child	Prince_Giuseppe_Count_of_Asti
Anna_of_Nassau_Dillenburg	hasSpouse	Yes
Charles_III_of_Spain	predecessor	Ferdinand_VI_of_Spain
Margaret_Marchioness_of_Namur	type	Person
Albert_V_Duke_of_Bavaria	type	Person
George_III	father	Frederick_Prince_of_Wales
Louis_IV_of_France	child	Lothair_of_France
Amadeus_III_Count_of_Savoy	predecessor	Humbert_II_Count_of_Savoy
Saint_Margaret_of_Scotland	father	Edward_the_Exile
Frederick_Prince_of_Wales	child	George_III
Isabella_of_Savoy	type	Person
Bona_of_Savoy	spouse	Galeazzo_Maria_Sforza
John_Count_of_Angoul_me	parent	Louis_I_Duke_of_Orl_ans
Lothair_II_of_Italy	successor	Berengar_II_of_Italy
Rudolf_I_of_Germany	child	Matilda_of_Habsburg
Robert_I_Duke_of_Burgundy	type	Person
William_Adelin	type	Person
John_I_Count_of_La_Marche	gender	male
Caroline_Bonaparte	type	Person
_thelwulf_King_of_Wessex	spouse	Judith_of_Flanders
Richard_FitzRoy	type	Person
Eadgifu_of_Wessex	parent	_lffl_d_wife_of_Edward_the_Elder
Sibylla_of_Anjou	hasSpouse	Yes
Ferdinand_Karl_Archduke_of_Austria_Este	child	Archduke_Ferdinand_Karl_Joseph_of_Austria_Este
Philip_III_of_Spain	child	Maria_Anna_of_Spain
Charles_III_of_Spain	mother	Elisabeth_Farnese
Peter_Duke_of_Coimbra	type	Person
Empress_Jos_phine	spouse	Alexandre_de_Beauharnais
Charles_the_Simple	type	Person
Francis_I_of_France	child	Madeleine_of_Valois
Isabella_de_Beauchamp	parent	Maud_FitzJohn_Countess_of_Warwick
Eug_ne_de_Beauharnais	type	Person
Beatriz_Pereira_de_Alvim	mother	Leonor_de_Alvim
Matilda_of_Bavaria_Margravine_of_Meissen	spouse	Frederick_II_Margrave_of_Meissen
Manuel_I_of_Portugal	spouse	Eleanor_of_Austria
Louis_I_of_Spain	type	Person
Philip_III_of_Spain	successor	Philip_IV_of_Spain
Wilhelmine_Amalie_of_Brunswick	type	Person
Charles_V_Holy_Roman_Emperor	hasSpouse	Yes
William_V_Duke_of_Aquitaine	parent	William_IV_Duke_of_Aquitaine
Louis_II_Duke_of_Bavaria	mother	Agnes_of_the_Palatinate
Louis_Count_of__vreux	parent	Philip_III_of_France
Bianca_Maria_Visconti	hasSpouse	Yes
Edward_the_Elder	child	Eadred
Henry_III_of_England	father	John_King_of_England
Alfonso_VIII_of_Castile	father	Sancho_III_of_Castile
Hedwig_of_Bavaria	gender	female
John_I_of_Aragon	spouse	Louis_II_of_Anjou
Elisabeth_of_Hesse_Electress_Palatine	type	Person
Beatrice_Regina_della_Scala	gender	female
Frederick_I_Count_of_Vaud_mont	hasSpouse	Yes
Conrad_I_Count_of_Auxerre	spouse	Adelaide_of_Tours
Hugh_III_Duke_of_Burgundy	type	Person
Willa_of_Tuscany	hasSpouse	Yes
Henry_II_of_England	child	John_King_of_England
Catherine_of_Anhalt_Bernburg	type	Person
Henry_X_Duke_of_Bavaria	mother	Wulfhilde_of_Saxony
Philip_II_Duke_of_Savoy	parent	Anne_of_Cyprus
Violant_of_Hungary	child	Isabella_of_Aragon_Queen_of_France
Marie_of_Cleves_Duchess_of_Orl_ans	type	Person
Anna_of_Nassau_Dillenburg	type	Person
John_IV_Duke_of_Brittany	spouse	Joan_Holland_Duchess_of_Brittany
Antoine_of_Navarre	spouse	Jeanne_d_Albret
Frederick_II_Duke_of_Lorraine	successor	Theobald_I_Duke_of_Lorraine
Hortense_de_Beauharnais	child	Napoleon_III
Elizabeth_the_Cuman	hasSpouse	Yes
Louis_I_Duke_of_Bourbon	parent	Beatrice_of_Burgundy_Lady_of_Bourbon
Ferdinand_Duke_of_Viseu	spouse	Beatriz_of_Portugal_Duchess_of_Viseu
Christine_of_Saxony	child	Christine_of_Hesse
Charles_Emmanuel_I_Duke_of_Savoy	parent	Margaret_of_Valois_Duchess_of_Berry
George_IV	type	Person
Maria_Josepha_of_Saxony_Dauphine_of_France	mother	Maria_Josepha_of_Austria
Charles_VII_Holy_Roman_Emperor	predecessor	Maria_Theresa
Maria_Josepha_of_Saxony_Dauphine_of_France	gender	female
John_of_Bohemia	child	Nicolaus_of_Luxemburg
Maria_Theresa_of_Naples_and_Sicily	child	Archduchess_Marie_Caroline_of_Austria
Napoleon	gender	male
Judith_of_Flanders	spouse	_thelwulf_King_of_Wessex
Princess_Elisabeth_Albertine_of_Saxe_Hildburghausen	type	Person
Catherine_of_Valois	mother	Isabeau_of_Bavaria
John_I_Duke_of_Brittany	parent	Alix_Duchess_of_Brittany
Gerard_Duke_of_Lorraine	gender	male
Theodoric_II_Duke_of_Lorraine	successor	Simon_I_Duke_of_Lorraine
John_George_I_Elector_of_Saxony	spouse	Magdalene_Sibylle_of_Prussia
Charles_IV_of_Spain	spouse	Maria_Luisa_of_Parma
Yolanda_Latin_Empress	child	Philip_II_Marquis_of_Namur
George_II_Landgrave_of_Hesse_Darmstadt	type	Person
Rozala_of_Italy	mother	Willa_of_Tuscany
Maria_Christina_Duchess_of_Teschen	type	Person
Urraca_of_Castile_Queen_of_Navarre	type	Person
Alfonso_VIII_of_Castile	child	Ferdinand_of_Castile_died_1211
Henry_I_Duke_of_Brabant	hasSpouse	Yes
Henry_Stuart_Lord_Darnley	spouse	Mary_Queen_of_Scots
Ramon_Berenguer_II_Count_of_Barcelona	parent	Ramon_Berenguer_I_Count_of_Barcelona
Teresa_Fern_ndez_de_Traba	spouse	Ferdinand_II_of_Le_n
Catherine_Woodville_Duchess_of_Buckingham	type	Person
Yolanda_Latin_Empress	father	Baldwin_V_Count_of_Hainaut
Odo_IV_Duke_of_Burgundy	father	Robert_II_Duke_of_Burgundy
Margaret_of_France_Queen_of_England	spouse	Edward_I_of_England
Charles_Emmanuel_III_of_Sardinia	child	Prince_Carlo_Francesco_Duke_of_Aosta
Nicholas_Francis_Duke_of_Lorraine	spouse	Claude_Fran_oise_de_Lorraine
Philip_II_Duke_of_Savoy	spouse	Margaret_of_Bourbon_1438_1483
Rudolph_II_of_Burgundy	hasSpouse	Yes
Fulk_King_of_Jerusalem	spouse	Ermengarde_Countess_of_Maine
Adela_of_Champagne	parent	Matilda_of_Carinthia
Magdalena_of_Saxony	type	Person
Maximilian_II_Holy_Roman_Emperor	father	Ferdinand_I_Holy_Roman_Emperor
Victor_Amadeus_II_of_Sardinia	father	Charles_Emmanuel_II_Duke_of_Savoy
Otto_I_Holy_Roman_Emperor	predecessor	Henry_the_Fowler
Arnulf_I_Count_of_Flanders	parent	Baldwin_II_Margrave_of_Flanders
Afonso_IV_of_Portugal	spouse	Beatrice_of_Castile_1293_1359
Otto_I_Count_of_Scheyern	type	Person
Louis_XVIII	parent	Maria_Josepha_of_Saxony_Dauphine_of_France
Hugh_the_Abbot	type	Person
Rupert_King_of_the_Romans	spouse	Elisabeth_of_Nuremberg
Eleanor_of_Castile_1307_1359	type	Person
Joan_of_France_1351_1371	type	Person
Infanta_Luisa_Fernanda_Duchess_of_Montpensier	child	Mercedes_of_Orl_ans
Golden_Ambrosian_Republic	successor	Francesco_I_Sforza
Maria_Carolina_of_Austria	child	Princess_Maria_Antonia_of_Naples_and_Sicily
John_VIII_Count_of_Vend_me	predecessor	Louis_Count_of_Vend_me
Louis_Philippe_II_Duke_of_Orl_ans	child	Louis_Charles_Count_of_Beaujolais
Princess_Maria_Carolina_of_Savoy	type	Person
Margaret_of_Anjou	father	Ren__of_Anjou
Afonso_III_of_Portugal	child	Denis_of_Portugal
Matilda_of_Frisia	hasSpouse	Yes
Margaret_Stewart_Dauphine_of_France	gender	female
Claude_Fran_oise_de_Lorraine	hasSpouse	Yes
Thomas_Arundel	type	Person
Bertha_Duchess_of_Lorraine	spouse	Matthias_I_Duke_of_Lorraine
James_Stewart_1st_Earl_of_Moray	type	Person
Matthias_II_Duke_of_Lorraine	successor	Frederick_III_Duke_of_Lorraine
Luisa_of_Naples_and_Sicily	type	Person
Robert_I_Duke_of_Burgundy	child	Henry_son_of_Robert_I_of_Burgundy
Maria_Amalia_of_Naples_and_Sicily	parent	Maria_Carolina_of_Austria
Louis_Duke_of_Savoy	hasSpouse	Yes
James_I_of_Aragon	spouse	Eleanor_of_Castile_died_1244
Ferdinand_II_of_Le_n	hasSpouse	Yes
Louis_XV	child	Madame_Ad_la_de
Charles_VII_of_France	child	Marie_de_Valois
Anabella_Drummond	spouse	Robert_III_of_Scotland
Sibylla_of_Anjou	mother	Ermengarde_Countess_of_Maine
Albert_II_Duke_of_Austria	parent	Albert_I_of_Germany
John_of_Gaunt	type	Person
Margaret_of_Valois_Angoul_me	spouse	Charles_IV_Duke_of_Alen_on
Fulk_III_Count_of_Anjou	hasSpouse	No
Empress_Matilda	mother	Matilda_of_Scotland
Ren__of_Anjou	successor	Charles_IV_of_Anjou
John_I_Duke_of_Lorraine	hasSpouse	Yes
Maria_Salviati	hasSpouse	Yes
Francis_II_Holy_Roman_Emperor	successor	Ferdinand_I_of_Austria
Odo_III_Duke_of_Burgundy	gender	male
Anne_Princess_Royal_and_Princess_of_Orange	type	Person
Pope	type	Person
John_of_Castile_Lord_of_Valencia_de_Campos	type	Person
Odo_II_Count_of_Blois	hasSpouse	Yes
Humbert_II_Count_of_Savoy	parent	Amadeus_II_Count_of_Savoy
Joanna_of_Bourbon	type	Person
William_X_Duke_of_Aquitaine	father	William_IX_Duke_of_Aquitaine
Maria_of_Aragon_Queen_of_Portugal	type	Person
Marie_of_France_Duchess_of_Bar	child	Henry_of_Bar
Yolande_of_Aragon	mother	Violant_of_Bar
Henry_II_of_Navarre	spouse	Margaret_of_Valois_Angoul_me
Charles_I_of_England	hasSpouse	Yes
Ferdinand_I_of_Aragon	hasSpouse	Yes
Beatrice_of_Vermandois	spouse	Robert_I_of_France
Carloman_II	successor	Charles_the_Fat
Robert_II_Duke_of_Burgundy	child	Odo_IV_Duke_of_Burgundy
Edward_III_of_England	parent	Isabella_of_France
Marie_Countess_of_Ponthieu	mother	Alys_of_France_Countess_of_Vexin
Stephen_III_Duke_of_Bavaria	type	Person
Stephen_King_of_England	type	Person
Maria_Amalia_of_Naples_and_Sicily	gender	female
Louis_of_Toulouse	type	Person
John_II_Count_of_Holland	hasSpouse	Yes
Alfonso_IX_of_Le_n	hasSpouse	Yes
Maria_of_Austria_Duchess_of_J_lich_Cleves_Berg	parent	Ferdinand_I_Holy_Roman_Emperor
Godfrey_I_Count_of_Louvain	gender	male
Prince_John_August_of_Saxe_Gotha_Altenburg	type	Person
Charlotte_of_Savoy	mother	Anne_of_Cyprus
John_II_of_France	name	John II
Catherine_de_Medici	child	Louis_of_Valois
William_IV_Duke_of_Aquitaine	parent	William_III_Duke_of_Aquitaine
Nicholas_d_Oisy_Lord_of_Avesnes	gender	male
Frederick_Hereditary_Prince_of_Saxony	type	Person
Arnulf_of_Carinthia	predecessor	Charles_the_Fat
Albert_II_Duke_of_Austria	gender	male
John_VIII_Count_of_Vend_me	hasSpouse	Yes
Dirk_III_Count_of_Holland	parent	Arnulf_Count_of_Holland
Charles_IV_Holy_Roman_Emperor	predecessor	John_of_Bohemia
Louis_Duke_of_Burgundy	gender	male
Peter_II_Duke_of_Bourbon	type	Person
Conrad_I_of_Burgundy	type	Person
Ludmilla_of_Bohemia	spouse	Louis_I_Duke_of_Bavaria
Magnus_II_Duke_of_Brunswic_L_neburg	hasSpouse	Yes
James_II_of_Scotland	child	James_III_of_Scotland
Afonso_II_of_Portugal	type	Person
Vladimir_the_Great	spouse	Anna_Porphyrogenita
Margaret_of_Valois_Angoul_me	type	Person
Poppa_of_Bayeux	parent	Berengar_II_of_Neustria
Maria_Theresa	predecessor	Charles_VI_Holy_Roman_Emperor
Fernando_Lord_of_Serpa	type	Person
Henry_Stuart_Lord_Darnley	hasSpouse	Yes
Anne_Marie_d_Orl_ans	parent	Philippe_I_Duke_of_Orl_ans
George_Gordon_4th_Earl_of_Huntly	type	Person
Louise_of_Savoy	child	Margaret_of_Valois_Angoul_me
Margaret_I_Countess_of_Flanders	type	Person
Philip_I_of_France	child	Louis_VI_of_France
Plectrude	spouse	Pepin_of_Herstal
Eleanor_of_Castile	successor	Edward_II_of_England
Louis_VII_of_France	child	Marie_of_France_Countess_of_Champagne
Louis_XIV	child	Louis_Auguste_Duke_of_Maine
Ernest_I_Duke_of_Brunswic_L_neburg	mother	Margaret_of_Saxony_Duchess_of_Brunswic_L_neburg
Princess_Elisabeth_Albertine_of_Saxe_Hildburghausen	child	Charlotte_of_Mecklenburg_Strelitz
Fran_oise_d_Alen_on	type	Person
Margaret_of_Brieg	father	Louis_I_of_Brzeg
Margaret_Stewart_Dauphine_of_France	type	Person
Albert_II_Duke_of_Austria	child	Leopold_III_Duke_of_Austria
Archduchess_Maria_Clementina_of_Austria	parent	Leopold_II_Holy_Roman_Emperor
Charles_Emmanuel_III_of_Sardinia	successor	Victor_Amadeus_III_of_Sardinia
Sophie_of_Thuringia_Duchess_of_Brabant	spouse	Henry_II_Duke_of_Brabant
Marie_of_France_Duchess_of_Bar	parent	John_II_of_France
Marie_of_Anjou	parent	Louis_II_of_Anjou
Henry_IV_of_France	child	Henrietta_Maria
Albert_I_Duke_of_Bavaria	type	Person
Ogive_of_Luxembourg	spouse	Baldwin_IV_Count_of_Flanders
Stephen_King_of_England	successor	Geoffrey_Plantagenet_Count_of_Anjou
Margaret_of_Savoy_Countess_of_Saint_Pol	parent	Anne_of_Cyprus
Charles_II_Archduke_of_Austria	spouse	Maria_Anna_of_Bavaria_born_1551
Luitgarde_of_Vermandois	parent	Herbert_II_Count_of_Vermandois
Maria_of_Aragon_Queen_of_Portugal	child	John_III_of_Portugal
Henry_the_Fowler	predecessor	Conrad_I_of_Germany
Sophia_Eleonore_of_Saxony	father	John_George_I_Elector_of_Saxony
Otto_I_Duke_of_Bavaria	hasSpouse	Yes
Eleanor_of_Portugal_Queen_of_Aragon	type	Person
Elizabeth_of_Bohemia_1292_1330	child	Margaret_of_Bohemia_Duchess_of_Bavaria
George_Duke_of_Brunswic_Calenberg	gender	male
Charles_IX_of_France	successor	Henry_III_of_France
Baldwin_IV_Count_of_Flanders	spouse	Ogive_of_Luxembourg
Maud_of_Normandy	type	Person
Berengaria_of_Castile	successor	Ferdinand_III_of_Castile
Napoleon	parent	Carlo_Buonaparte
Countess_of_Pembroke	type	Person
James_III_of_Scotland	father	James_II_of_Scotland
Isabella_of_Portugal	gender	female
Mary_of_Burgundy	spouse	Maximilian_I_Holy_Roman_Emperor
Charles_V_Duke_of_Lorraine	gender	male
Matilda_of_Brabant_Countess_of_Artois	mother	Maria_of_Swabia
William_de_Beauchamp_9th_Earl_of_Warwick	hasSpouse	Yes
Francis_I_Duke_of_Lorraine	type	Person
Ermengarde_of_Anjou_Duchess_of_Burgundy	hasSpouse	Yes
Eleanor_of_Castile_died_1244	spouse	James_I_of_Aragon
Louis_Count_of_Vend_me	mother	Catherine_of_Vend_me
William_IV_Duke_of_Aquitaine	parent	Gerloc
Afonso_II_of_Portugal	successor	Sancho_II_of_Portugal
William_X_Duke_of_Aquitaine	successor	Eleanor_of_Aquitaine
Francis_Count_of_Vend_me	parent	John_VIII_Count_of_Vend_me
Maria_Theresa_of_Naples_and_Sicily	child	Maria_Leopoldina_of_Austria
Maria_Luisa_of_Spain	spouse	Leopold_II_Holy_Roman_Emperor
William_of_Winchester_Lord_of_Lunenburg	gender	male
Charles_V_Duke_of_Lorraine	spouse	Eleonore_of_Austria_Queen_of_Poland
Beatrice_of_Albon	type	Person
Philip_IV_of_Spain	mother	Margaret_of_Austria_Queen_of_Spain
Walter_archbishop_of_Sens	hasSpouse	No
Theobald_I_Count_of_Blois	gender	male
Elizabeth_of_Bohemia_1292_1330	child	Bonne_of_Luxembourg
Willa_of_Tuscany	type	Person
Edward_III_of_England	type	Person
Alpaida	gender	female
Joanna_of_Castile	child	Ferdinand_I_Holy_Roman_Emperor
Maria_Theresa	child	Archduchess_Maria_Johanna_Gabriela_of_Austria
Liudolf_Margrave_of_Frisia	gender	male
Prince_Edward_Duke_of_Kent_and_Strathearn	type	Person
Simon_II_Duke_of_Lorraine	predecessor	Matthias_I_Duke_of_Lorraine
Rudolph_I_of_Burgundy	gender	male
Nicholas_d_Oisy_Lord_of_Avesnes	parent	Walter_I_Lord_of_Avesnes
Antoine_of_Navarre	successor	Jeanne_d_Albret
Henry_the_Fowler	parent	Otto_I_Duke_of_Saxony
Henry_I_of_Castile	type	Person
Marie_de_Medici	parent	Francesco_I_de_Medici_Grand_Duke_of_Tuscany
Richard_II_of_England	successor	John_of_Gaunt
Eleanor_of_Aragon_Queen_of_Portugal	child	Ferdinand_Duke_of_Viseu
William_the_Younger_Duke_of_Brunswic_L_neburg	hasSpouse	Yes
Elisabeth_of_Nuremberg	child	Otto_I_Count_Palatine_of_Mosbach
Maximilian_II_Holy_Roman_Emperor	type	Person
Berengaria_of_Barcelona	gender	female
Charles_the_Fat	parent	Louis_the_German
Antonio_Farnese_Duke_of_Parma	type	Person
Isabella_of_France	gender	female
Duchess_Helene_of_Mecklenburg_Schwerin	parent	Frederick_Louis_Hereditary_Grand_Duke_of_Mecklenburg_Schwerin
Countess_Palatine_Caroline_of_Zweibr_cken	father	Christian_III_Count_Palatine_of_Zweibr_cken
James_IV_of_Scotland	predecessor	James_III_of_Scotland
Charles_Emmanuel_I_Duke_of_Savoy	predecessor	Emmanuel_Philibert_Duke_of_Savoy
Maria_Christina_of_the_Two_Sicilies	child	Mar_a_Amparo_Mu_oz_y_Borb_n_1st_Countess_of_Vista_Alegre
Bertrade_of_Montfort	father	Simon_I_de_Montfort
Philip_III_of_Navarre	spouse	Joan_II_of_Navarre
Marie_of_Brittany_Countess_of_Saint_Pol	hasSpouse	Yes
Philip_I_of_Castile	type	Person
John_II_of_France	type	Person
Pepin_of_Herstal	child	Childebrand_I
Edward_King_of_Portugal	father	John_I_of_Portugal
Peter_I_of_Portugal	child	Denis_Lord_of_Cifuentes
John_Stewart_3rd_Earl_of_Lennox	parent	Matthew_Stewart_2nd_Earl_of_Lennox
Louis_I_Duke_of_Orl_ans	mother	Joanna_of_Bourbon
Beatrice_of_Portugal_died_1381	child	Fernando_S_nchez_2nd_Count_of_Alburquerque
Anne_of_Foix_Candale	spouse	Vladislaus_II_of_Hungary
Albert_I_of_Germany	child	Leopold_I_Duke_of_Austria
Otto_I_Duke_of_Saxony	spouse	Hedwig_of_Babenberg
Adelaide_of_Leuven	type	Person
Antoine_Count_of_Vaud_mont	hasSpouse	Yes
Odo_I_Duke_of_Burgundy	child	Helie_of_Burgundy
Henry_II_of_England	father	Geoffrey_Plantagenet_Count_of_Anjou
Philippa_of_Bar	type	Person
Bona_of_Savoy	child	Hermes_Maria_Sforza
Landgravine_Elisabeth_Amalie_of_Hesse_Darmstadt	child	Philip_William_August_Count_Palatine_of_Neuburg
Afonso_IV_of_Portugal	predecessor	Denis_of_Portugal
Lothair_of_France	child	Louis_V_of_France
Alpaida	hasSpouse	Yes
Odo_of_France	hasSpouse	Yes
Louise_Fran_oise_de_Bourbon_Duchess_of_Bourbon	type	Person
John_of_Montfort	mother	Yolande_of_Dreux_Queen_of_Scotland
Agnes_de_Baudemont_Countess_of_Braine	type	Person
Anne_of_Bohemia_and_Hungary	child	Maria_of_Austria_Duchess_of_J_lich_Cleves_Berg
Philip_V_of_France	predecessor	John_I_of_France
Margaret_of_Savoy_Countess_of_Saint_Pol	gender	female
Victor_Amadeus_II_of_Sardinia	parent	Charles_Emmanuel_II_Duke_of_Savoy
Anne_of_Burgundy	type	Person
Mary_of_Hungary_Queen_of_Naples	child	Maria_of_Naples
Blanche_I_of_Navarre	spouse	John_II_of_Aragon
Eadred	type	Person
Geoffrey_Plantagenet_Count_of_Anjou	gender	male
Helena_of_Denmark	spouse	William_of_Winchester_Lord_of_Lunenburg
Gerolf_of_Holland	successor	Dirk_I_Count_of_Holland
Otto_I_Duke_of_Brunswic_L_neburg	hasSpouse	Yes
Gerard_Duke_of_Lorraine	successor	Theodoric_II_Duke_of_Lorraine
Eleanor_of_Anjou	type	Person
Countess_Palatine_Caroline_of_Zweibr_cken	child	Princess_Amalie_of_Hesse_Darmstadt
Louis_the_Pious	type	Person
Yaroslav_the_Wise	parent	Vladimir_the_Great
Marie_of_Luxembourg_Queen_of_France	hasSpouse	Yes
Galeazzo_Maria_Sforza	spouse	Bona_of_Savoy
George_Gordon_4th_Earl_of_Huntly	child	George_Gordon_5th_Earl_of_Huntly
Francis_II_of_France	parent	Catherine_de_Medici
Henri_Count_of_Chambord	predecessor	Louis_Antoine_Duke_of_Angoul_me
Baldwin_II_Count_of_Hainaut	type	Person
Iziaslav_I_of_Kiev	type	Person
Frederick_III_Holy_Roman_Emperor	predecessor	Albert_II_of_Germany
Louis_Duke_of_Savoy	child	Louis_of_Cyprus
Ferdinand_I_of_Aragon	father	John_I_of_Castile
Hugh_Capet	parent	Hugh_the_Great
Richard_Duke_of_Burgundy	parent	Bivin_of_Gorze
Henry_II_of_England	child	Matilda_of_England_Duchess_of_Saxony
William_X_Duke_of_Aquitaine	parent	Philippa_Countess_of_Toulouse
Louis_IX_of_France	father	Louis_VIII_of_France
Anne_of_Austria	type	Person
Philip_IV_of_France	parent	Isabella_of_Aragon_Queen_of_France
Andrew_II_of_Hungary	spouse	Yolanda_of_Courtenay
George_I_of_Great_Britain	hasSpouse	Yes
Charles_V_Holy_Roman_Emperor	predecessor	Philip_I_of_Castile
John_Stewart_of_Darnley	hasSpouse	No
Louise_of_Great_Britain	type	Person
Charles_Count_of_Valois	spouse	Catherine_I_Latin_Empress
Princess_Christine_Louise_of_Oettinge_Oettingen	gender	female
Mar_a_de_Molina	type	Person
Volodar_Glebovich_Prince_of_Minsk	type	Person
Charlotte_of_Savoy	parent	Louis_Duke_of_Savoy
Adele_of_Vermandois	spouse	Arnulf_I_Count_of_Flanders
Isabella_of_Aragon_Queen_of_France	hasSpouse	Yes
George_Duke_of_Brunswic_Calenberg	parent	Dorothea_of_Denmark_Duchess_of_Brunswic_L_neburg
Peter_I_Duke_of_Brittany	child	Yolande_of_Brittany
Henry_II_of_Navarre	successor	Antoine_of_Navarre
Joan_II_of_Navarre	parent	Margaret_of_Burgundy_Queen_of_France
Henry_I_Duke_of_Brabant	parent	Godfrey_III_Count_of_Louvain
Stephen_III_of_Auxonne	parent	Stephen_II_of_Auxonne
Anna_Maria_of_Mecklenburg_Schwerin	father	Adolphus_Frederick_I_Duke_of_Mecklenburg_Schwerin
Geoffrey_Plantagenet_Count_of_Anjou	spouse	Empress_Matilda
Ramon_Berenguer_II_Count_of_Barcelona	type	Person
George_III	child	William_IV
Antoinette_of_Bourbon	father	Francis_Count_of_Vend_me
Ramon_Berenguer_IV_Count_of_Provence	child	Sanchia_of_Provence
Maria_Carolina_of_Austria	child	Maria_Henrietta_of_Naples_and_Sicily
Isabella_of_Castile_Queen_of_Aragon	type	Person
Polissena_Ruffo	spouse	Francesco_I_Sforza
Eleanor_of_Lancaster	spouse	John_de_Beaumont_2nd_Baron_Beaumont
Afonso_I_Duke_of_Braganza	spouse	Beatriz_Pereira_de_Alvim
Maria_Theresa_of_Austria_1767_1827	type	Person
Louis_I_Duke_of_Orl_ans	father	Charles_V_of_France
John_II_of_Portugal	gender	male
Charlotte_of_Mecklenburg_Strelitz	parent	Duke_Charles_Louis_Frederick_of_Mecklenburg
Philip_I_of_France	father	Henry_I_of_France
Simon_I_Duke_of_Lorraine	child	Matthias_I_Duke_of_Lorraine
Joan_Fitzalan_Countess_of_Hereford	gender	female
Guisla_de_Llu__	type	Person
Henry_Count_of_Portugal	marriedTo	Theresa_Countess_of_Portugal
Marie_Louise_Duchess_of_Parma	father	Francis_II_Holy_Roman_Emperor
Gertrude_of_Hohenberg	mother	Matilda_of_T_bingen
Anne_of_Brittany	hasSpouse	Yes
Edward_the_Elder	child	Edith_of_Polesworth
Violant_of_Hungary	child	Peter_III_of_Aragon
Isabella_of_Hainault	type	Person
Frederick_IV_Duke_of_Lorraine	type	Person
John_of_Burgundy_1231_68	type	Person
Countess_Palatine_Dorothea_Sophie_of_Neuburg	mother	Landgravine_Elisabeth_Amalie_of_Hesse_Darmstadt
Hildegarde_of_Burgundy	hasSpouse	Yes
Henrietta_Maria	hasSpouse	Yes
Lothair_II_of_Italy	parent	Hugh_of_Italy
Yaroslav_the_Wise	child	Vladimir_of_Novgorod
Yolanda_Latin_Empress	successor	Robert_I_Latin_Emperor
Margaret_of_Savoy_Countess_of_Saint_Pol	parent	Louis_Duke_of_Savoy
Albert_Azzo_II_Margrave_of_Milan	parent	Albert_Azzo_I_Margrave_of_Milan
William_VIII_Duke_of_Aquitaine	parent	Agnes_of_Burgundy_Duchess_of_Aquitaine
John_II_Duke_of_Brittany	parent	Blanche_of_Navarre_Duchess_of_Brittany
Bertrade_of_Montfort	child	Fulk_King_of_Jerusalem
Elisabeth_of_France_1602_1644	type	Person
Lorenzo_the_Elder	parent	Giovanni_di_Bicci_de_Medici
Charles_Ren__de_Bombelles	spouse	Marie_Louise_Duchess_of_Parma
Margaret_of_Bourbon_1438_1483	spouse	Philip_II_Duke_of_Savoy
Alfonso_XI_of_Castile	mother	Constance_of_Portugal
Margaret_of_Bourbon_Queen_of_Navarre	type	Person
Charles_VII_of_France	parent	Isabeau_of_Bavaria
Ermentrude_de_Roucy	hasSpouse	Yes
Yolanda_Latin_Empress	child	Robert_I_Latin_Emperor
Robert_I_of_France	father	Robert_the_Strong
Elisabeth_of_Valois	spouse	Philip_II_of_Spain
Ermentrude_of_Orl_ans	parent	Engeltrude_de_F_zensac
Sophia_Dorothea_of_Hanover	type	Person
Charles_Martel	type	Person
Sophia_of_Saxe_Weissenfels_Princess_of_Anhalt_Zerbst	gender	female
Maria_Teresa_Cybo_Malaspina_Duchess_of_Massa	gender	female
Ferdinand_I_Holy_Roman_Emperor	successor	Charles_II_Archduke_of_Austria
Anne_of_Cyprus	child	Charlotte_of_Savoy
Geoffrey_Plantagenet_Count_of_Anjou	successor	Henry_II_of_England
Pepin_the_Short	spouse	Bertrada_of_Laon
Robert_Duke_of_Bar	type	Person
Alice_Holland_Countess_of_Kent	parent	Richard_Fitzalan_3rd_Earl_of_Arundel
Peter_I_of_Portugal	father	Afonso_IV_of_Portugal
Engeltrude_de_F_zensac	hasSpouse	Yes
In_s_de_Castro	gender	female
Odo_III_Duke_of_Burgundy	spouse	Alice_of_Vergy
Francis_IV_Duke_of_Modena	parent	Maria_Beatrice_d_Este_Duchess_of_Massa
Louis_VI_of_France	mother	Bertha_of_Holland
Maria_of_Aragon_Queen_of_Portugal	child	Henry_King_of_Portugal
Antoine_of_Navarre	gender	male
Anne_of_Kiev	gender	female
Nicholas_Francis_Duke_of_Lorraine	type	Person
Ingegerd_Olofsdotter_of_Sweden	gender	female
Louis_IX_of_France	child	Margaret_of_France_Duchess_of_Brabant
Wilhelmine_Amalie_of_Brunswick	gender	female
Fulk_King_of_Jerusalem	spouse	Melisende_Queen_of_Jerusalem
Amadeus_II_Count_of_Savoy	hasSpouse	No
Alfonso_IX_of_Le_n	gender	male
Eleanor_of_Lancaster	mother	Maud_Chaworth
Isabeau_of_Bavaria	gender	female
Philip_V_of_Spain	type	Person
Louis_Philippe_I	successor	Prince_Philippe_Count_of_Paris
Isambart	hasSpouse	No
Countess_Palatine_Dorothea_Sophie_of_Neuburg	gender	female
Elisabeth_of_Nuremberg	hasSpouse	Yes
John_II_of_Aragon	child	Eleanor_of_Navarre
Henry_VII_Holy_Roman_Emperor	child	Marie_of_Luxembourg_Queen_of_France
Blanche_of_Brittany	parent	Beatrice_of_England
Henrietta_Maria	parent	Marie_de_Medici
Princess_Elisabeth_Albertine_of_Saxe_Hildburghausen	child	Duke_George_Augustus_of_Mecklenburg
Lambert_II_Count_of_Louvain	mother	Gerberga_of_Lower_Lorraine
Louis_XVII	mother	Marie_Antoinette
Anne_of_Kiev	parent	Yaroslav_the_Wise
Duke_Charles_Louis_Frederick_of_Mecklenburg	hasSpouse	Yes
Petronilla_of_Aragon	type	Person
Hugh_Capet	parent	Hedwig_of_Saxony
Otto_V_Duke_of_Brunswic_L_neburg	parent	Frederick_II_Duke_of_Brunswic_L_neburg
Charles_Emmanuel_I_Duke_of_Savoy	successor	Victor_Amadeus_I_Duke_of_Savoy
Berenguer_Ramon_I_Count_of_Barcelona	parent	Ramon_Borrell_Count_of_Barcelona
Fulk_II_Count_of_Anjou	type	Person
Princess_Caroline_Louise_of_Saxe_Weimar_Eisenach	father	Karl_August_Grand_Duke_of_Saxe_Weimar_Eisenach
Louis_Dauphin_of_France_son_of_Louis_XV	type	Person
Marie_Th_r_se_of_France	hasSpouse	Yes
Landgravine_Elisabeth_Amalie_of_Hesse_Darmstadt	child	Maria_Anna_of_Neuburg
Galeazzo_Maria_Sforza	predecessor	Francesco_I_Sforza
Patrick_de_Chaworth_Lord_of_Kidwelly	type	Person
Ramon_Berenguer_IV_Count_of_Provence	successor	Beatrice_of_Provence
Theobald_II_Count_of_Champagne	mother	Adela_of_Normandy
Cymburgis_of_Masovia	type	Person
Ferdinand_II_of_Aragon	child	Joanna_of_Castile
Charles_Duke_of_Orl_ans	mother	Valentina_Visconti_Duchess_of_Orl_ans
Heilika_of_Lengenfeld	type	Person
Theodoric_II_Duke_of_Lorraine	gender	male
Marie_of_Bade_Sponheim	successor	Archduchess_Anna_of_Austria
Louis_I_of_Anjou	child	Louis_II_of_Anjou
Rudolph_Duke_of_Lorraine	type	Person
Henry_IV_of_France	parent	Jeanne_d_Albret
Fran_oise_Ath_na_s_de_Rochechouart_Marquise_de_Montespan	spouse	Louis_XIV
Alfonso_IX_of_Le_n	father	Ferdinand_II_of_Le_n
Empress_Matilda	father	Henry_I_of_England
Anne_Marie_d_Orl_ans	mother	Henrietta_of_England
Afonso_V_of_Portugal	parent	Edward_King_of_Portugal
Agatha_wife_of_Edward_the_Exile	type	Person
Philip_V_of_France	mother	Joan_I_of_Navarre
Joan_II_Countess_of_Burgundy	gender	female
Blanche_of_Castile	child	Robert_I_Count_of_Artois
Baldwin_II_Margrave_of_Flanders	spouse	_lfthryth_Countess_of_Flanders
Manuel_I_of_Portugal	type	Person
Charlotte_of_Savoy	hasSpouse	Yes
Ramon_Berenguer_I_Count_of_Barcelona	hasSpouse	Yes
George_III	predecessor	George_II_of_Great_Britain
Arnulf_Count_of_Holland	parent	Dirk_II_Count_of_Holland
Igor_of_Kiev	spouse	Olga_of_Kiev
Anna_of_Hungary_Byzantine_empress	type	Person
Salomea_of_Berg	father	Henry_I_Count_of_Berg
Jacquetta_of_Luxembourg	spouse	John_of_Lancaster_1st_Duke_of_Bedford
Archduchess_Anna_of_Austria	successor	Renata_of_Lorraine
Patrick_de_Chaworth_Lord_of_Kidwelly	hasSpouse	No
Arnulf_Count_of_Holland	type	Person
Ingeborg_of_Denmark_Queen_of_France	parent	Sophia_of_Minsk
Ermengarde_of_Anjou_Duchess_of_Burgundy	spouse	Robert_I_Duke_of_Burgundy
Anne_of_Brittany	child	Ren_e_of_France
Robert_II_Count_of_Dreux	successor	Robert_III_Count_of_Dreux
Maria_Luisa_of_Parma	gender	female
Louis_IX_of_France	predecessor	Louis_VIII_of_France
Sancho_II_of_Portugal	type	Person
Fulk_King_of_Jerusalem	child	Matilda_of_Anjou
Ferdinand_IV_of_Castile	hasSpouse	Yes
Albert_I_of_Germany	hasSpouse	Yes
John_the_Fearless	child	Mary_of_Burgundy_Duchess_of_Cleves
Francis_I_Duke_of_Lorraine	successor	Charles_III_Duke_of_Lorraine
Albert_II_Duke_of_Brunswic_L_neburg	name	Albert II
Yolanda_of_Courtenay	gender	female
Louise_Marie_Ad_la_de_de_Bourbon_Duchess_of_Orl_ans	mother	Maria_Teresa_Felicitas_d_Este
Maria_Luisa_of_Spain	father	Charles_III_of_Spain
Baldwin_III_Count_of_Flanders	hasSpouse	Yes
Louis_I_Duke_of_Bavaria	parent	Agnes_of_Loon
Arthur_II_Duke_of_Brittany	father	John_II_Duke_of_Brittany
Louis_Dauphin_of_France_son_of_Louis_XV	child	Louis_Duke_of_Burgundy_1751_1761
Louis_Count_of_Vend_me	parent	Catherine_of_Vend_me
Sigismund_II_Augustus	successor	Henry_III_of_France
Arnulf_II_Count_of_Flanders	type	Person
Hildegarde_of_Burgundy	spouse	William_VIII_Duke_of_Aquitaine
Princess_Marie_Isabelle_of_Orl_ans	type	Person
Stephen_Count_of_Blois	hasSpouse	Yes
Ren__of_Anjou	parent	Louis_II_of_Anjou
Peter_of_Castile_Lord_of_Cameros	type	Person
Fadrique_Alfonso	type	Person
Princess_Louise_of_Hesse_Darmstadt_1757_1830	mother	Countess_Palatine_Caroline_of_Zweibr_cken
Elisabeth_of_Nuremberg	spouse	Rupert_King_of_the_Romans
William_I_Duke_of_Bavaria	type	Person
Margaret_of_Nevers	type	Person
Mariana_of_Austria	type	Person
John_Constable_of_Portugal	spouse	Isabel_of_Barcelos
Yolanda_of_Courtenay	mother	Yolanda_Latin_Empress
Francis_I_Duke_of_Lorraine	predecessor	Antoine_Duke_of_Lorraine
Henry_IV_of_France	gender	male
Maria_Amalia_of_Saxony	child	Charles_IV_of_Spain
Rudolf_I_of_Germany	child	Rudolf_II_Duke_of_Austria
Anna_of_Austria_Queen_of_Spain	spouse	Philip_II_of_Spain
Henry_IV_of_France	predecessor	Henry_III_of_France
_thelwulf_King_of_Wessex	father	Ecgberht_King_of_Wessex
Fulk_IV_Count_of_Anjou	mother	Ermengarde_of_Anjou_Duchess_of_Burgundy
Thomas_Beaufort_Duke_of_Exeter	type	Person
Eadgifu_of_Wessex	father	Edward_the_Elder
Maud_Chaworth	gender	female
Louis_XII	predecessor	Charles_VIII_of_France
Louis_VIII_of_France	child	Robert_I_Count_of_Artois
Edward_II_of_England	predecessor	Edward_I_of_England
Elizabeth_Gordon_Countess_of_Huntly	spouse	George_Gordon_4th_Earl_of_Huntly
Blanche_of_Artois	type	Person
George_I_of_Great_Britain	parent	Sophia_of_Hanover
Guy_Count_of_Flanders	type	Person
Philip_William_August_Count_Palatine_of_Neuburg	type	Person
Helie_of_Semur	hasSpouse	Yes
Beatrice_of_England	child	Blanche_of_Brittany
Ferdinand_Philippe_Duke_of_Orl_ans	child	Prince_Robert_Duke_of_Chartres
Charles_X	parent	Louis_Dauphin_of_France_son_of_Louis_XV
Lothair_of_France	father	Louis_IV_of_France
Henry_V_Count_Palatine_of_the_Rhine	type	Person
Anne_of_Kiev	spouse	Henry_I_of_France
Eleanor_of_Lancaster	gender	female
Sancho_I_of_Portugal	gender	male
Matthias_I_Duke_of_Lorraine	mother	Adelaide_of_Leuven
Louis_VI_of_France	child	Peter_I_of_Courtenay
Peter_I_of_Portugal	child	John_I_of_Portugal
Robert_II_Count_of_Dreux	parent	Agnes_de_Baudemont_Countess_of_Braine
Mary_of_Burgundy_Duchess_of_Cleves	parent	John_the_Fearless
Louis_XV	gender	male
Louis_the_German	gender	male
Elisabeth_of_Nuremberg	gender	female
Philippe_II_Duke_of_Orl_ans	gender	male
Matilda_of_England_Duchess_of_Saxony	type	Person
Charles_Duke_of_Vend_me	child	Charles_de_Bourbon_cardinal
Louis_X_of_France	type	Person
Louis_XV	child	Th_r_se_of_France_1736_1744
Robert_I_Count_of_Artois	type	Person
Maria_of_Austria_Holy_Roman_Empress	child	Rudolf_II_Holy_Roman_Emperor
Adelaide_of_Tours	gender	female
Isabella_I_of_Castile	parent	Isabella_of_Portugal_Queen_of_Castile
Margaret_Boswell	type	Person
James_II_of_Scotland	child	David_Stewart_Earl_of_Moray
John_III_Count_of_Auvergne	type	Person
Letizia_Bonaparte	child	Elisa_Bonaparte
Maria_Teresa_Felicitas_d_Este	child	Louis_Marie_Duke_of_Rambouillet
Magdalene_Sibylle_of_Prussia	parent	Marie_Eleonore_of_Cleves
Frederick_II_Margrave_of_Meissen	hasSpouse	Yes
Matthew_Stewart_4th_Earl_of_Lennox	gender	male
Hildegard_of_the_Vinzgau	hasSpouse	Yes
Ferdinand_I_Holy_Roman_Emperor	type	Person
Joanna_of_Flanders	spouse	John_of_Montfort
John_of_Bohemia	type	Person
Thankmar	type	Person
Francis_I_of_the_Two_Sicilies	spouse	Archduchess_Maria_Clementina_of_Austria
Catherine_of_Lorraine_1573_1648	type	Person
Louis_II_Duke_of_Bourbon	type	Person
Beatrice_of_England	spouse	John_II_Duke_of_Brittany
Eleanor_of_Castile	child	Edward_II_of_England
Oberto_II_Margrave_of_Milan	parent	Oberto_I
Baldwin_V_Count_of_Flanders	gender	male
Odo_IV_Duke_of_Burgundy	type	Person
Maximilian_II_Holy_Roman_Emperor	child	Archduke_Ernest_of_Austria
Afonso_V_of_Portugal	successor	John_II_of_Portugal
Ecgberht_King_of_Wessex	father	Ealhmund_of_Kent
John_II_of_Cyprus	type	Person
Archduchess_Maria_Dorothea_of_Austria	predecessor	Princess_Marie_Isabelle_of_Orl_ans
Beatriz_Pereira_de_Alvim	type	Person
Theobald_II_Count_of_Champagne	hasSpouse	Yes
Joanna_of_Austria_Grand_Duchess_of_Tuscany	child	Philip_de_Medici
Violant_of_Aragon	hasSpouse	Yes
Yolanda_Latin_Empress	gender	female
Robert_I_Count_of_Flanders	spouse	Gertrude_of_Saxony
Wilfred_the_Hairy	type	Person
Henry_VI_of_England	parent	Henry_V_of_England
Henry_V_of_England	hasSpouse	Yes
Ferdinand_Philippe_Duke_of_Orl_ans	parent	Louis_Philippe_I
Anne_of_York_daughter_of_Edward_IV	type	Person
Marie_of_Brabant_Queen_of_France	type	Person
Constance_of_Aragon_Lady_of_Villena	type	Person
Stephen_III_Duke_of_Bavaria	hasSpouse	Yes
Dorothea_of_Denmark_Duchess_of_Brunswic_L_neburg	spouse	William_the_Younger_Duke_of_Brunswic_L_neburg
John_I_of_Castile	name	John I
Edward_the_Elder	mother	Ealhswith
Agnes_of_Loon	type	Person
Mary_Queen_of_Scots	type	Person
Robert_II_Duke_of_Burgundy	hasSpouse	Yes
John_I_of_Portugal	name	John I
Robert_III_Count_of_Dreux	hasSpouse	No
Alfonso_VIII_of_Castile	successor	Henry_I_of_Castile
George_Gordon_4th_Earl_of_Huntly	child	James_Gordon_Jesuit
Francis_I_Holy_Roman_Emperor	successor	Leopold_II_Holy_Roman_Emperor
John_of_Bohemia	parent	Henry_VII_Holy_Roman_Emperor
Bartholomew_de_L_Isle_Bouchard	type	Person
Francis_III_Duke_of_Brittany	type	Person
Antoinette_of_Bourbon	child	Mary_of_Guise
Rudolph_Duke_of_Lorraine	mother	Elisabeth_of_Austria_Duchess_of_Lorraine
Isabella_Duchess_of_Lorraine	father	Charles_II_Duke_of_Lorraine
_thelwulf_King_of_Wessex	child	_thelred_I_King_of_Wessex
Francis_II_Duke_of_Brittany	type	Person
Vladislaus_II_of_Hungary	spouse	Anne_of_Foix_Candale
Isabella_of_Aragon_Queen_of_France	father	James_I_of_Aragon
Ermentrude_of_Orl_ans	mother	Engeltrude_de_F_zensac
Margaret_of_Austria_Queen_of_Spain	child	Cardinal_Infante_Ferdinand_of_Austria
Joan_Beaufort_Queen_of_Scots	spouse	James_I_of_Scotland
Louis_XI	parent	Marie_of_Anjou
Mary_Queen_of_Scots	spouse	Henry_Stuart_Lord_Darnley
Christine_of_France	hasSpouse	Yes
Francis_I_Holy_Roman_Emperor	hasSpouse	Yes
Margaret_of_Brunswic_L_neburg	type	Person
Emma_of_Italy	mother	Adelaide_of_Italy
Matilda_of_Boulogne_Duchess_of_Brabant	type	Person
Emmanuel_Philibert_Duke_of_Savoy	gender	male
Henry_II_Count_of_Louvain	hasSpouse	No
Odo_III_Duke_of_Burgundy	father	Hugh_III_Duke_of_Burgundy
Isabella_Duchess_of_Lorraine	parent	Charles_II_Duke_of_Lorraine
Margaret_of_Brabant	type	Person
Maria_Cristina_of_Savoy	type	Person
_lffl_d_wife_of_Edward_the_Elder	spouse	Edward_the_Elder
Denis_of_Portugal	parent	Afonso_III_of_Portugal
Margaret_of_Bourbon_Queen_of_Navarre	spouse	Theobald_I_of_Navarre
Matthias_I_Duke_of_Lorraine	predecessor	Simon_I_Duke_of_Lorraine
Mary_Tudor_Queen_of_France	spouse	Charles_Brandon_1st_Duke_of_Suffolk
Jacques_Charles_Dupont_de_l_Eure	predecessor	Louis_Philippe_I
Ferdinand_II_Holy_Roman_Emperor	type	Person
Maria_Antonia_Ferdinanda_of_Spain	type	Person
Alice_of_Namur	type	Person
Peter_of_Courtenay_Lord_of_Conches	gender	male
Charles_III_Duke_of_Lorraine	predecessor	Francis_I_Duke_of_Lorraine
Joan_III_Countess_of_Burgundy	parent	Joan_II_Countess_of_Burgundy
Walter_archbishop_of_Sens	type	Person
Isabella_of_France	type	Person
John_of_Gaunt	successor	Henry_IV_of_England
Maria_Theresa_of_Spain	type	Person
_lisabeth_Charlotte_d_Orl_ans	spouse	Leopold_Duke_of_Lorraine
Prince_Frederick_of_Great_Britain	type	Person
John_I_of_Castile	parent	Juana_Manuel
Louis_IX_of_France	child	John_Tristan_Count_of_Valois
Louis_the_Stammerer	parent	Charles_the_Bald
Judith_of_Flanders_died_1095	type	Person
John_VII_Duke_of_Mecklenburg_Schwerin	parent	John_Albert_I_Duke_of_Mecklenburg
Philippe_I_Duke_of_Orl_ans	hasSpouse	Yes
Bona_of_Savoy	child	Bianca_Maria_Sforza
Alice_of_Normandy	hasSpouse	Yes
Alfonso_VIII_of_Castile	predecessor	Sancho_III_of_Castile
Henry_the_Fowler	father	Otto_I_Duke_of_Saxony
Fulk_I_Count_of_Anjou	parent	Adelais_of_Amboise
Prince_Philippe_Count_of_Paris	parent	Duchess_Helene_of_Mecklenburg_Schwerin
Blanche_of_Burgundy	hasSpouse	Yes
Maria_Josepha_of_Saxony_Dauphine_of_France	parent	Maria_Josepha_of_Austria
Joan_I_Countess_of_Auvergne	gender	female
Violant_of_Hungary	hasSpouse	Yes
Catherine_de_Medici	parent	Lorenzo_de_Medici_Duke_of_Urbino
Louis_IV_Holy_Roman_Emperor	gender	male
Isabella_of_Portugal	child	Philip_II_of_Spain
Elizabeth_the_Cuman	child	Anna_of_Hungary_Byzantine_empress
Edward_II_of_England	successor	Edward_III_of_England
Saint_Margaret_of_Scotland	child	Mary_of_Scotland_Countess_of_Boulogne
Anne_of_Kiev	child	Philip_I_of_France
Adolph_I_Duke_of_Cleves	type	Person
Maria_Beatrice_d_Este_Duchess_of_Massa	gender	female
John_I_of_Portugal	parent	Teresa_Louren_o
Eleanor_de_Guzm_n	type	Person
Bertrade_of_Montfort	spouse	Philip_I_of_France
Robert_III_of_Scotland	type	Person
Adela_of_Champagne	mother	Matilda_of_Carinthia
Henry_II_of_France	type	Person
Clementia_of_Hungary	parent	Charles_Martel_of_Anjou
Victor_Emmanuel_I_of_Sardinia	type	Person
Ermentrude_of_Orl_ans	child	Louis_the_Stammerer
George_II_of_Great_Britain	child	Princess_Caroline_Elizabeth_of_Great_Britain
Eleanor_of_Austria	father	Philip_I_of_Castile
Louis_VII_of_France	successor	Philip_II_of_France
Baldwin_II_Latin_Emperor	type	Person
Barbara_Jagiellon	parent	Casimir_IV_Jagiellon
Joan_of__vreux	type	Person
Countess_Caroline_of_Nassau_Saarbr_cken	type	Person
Louis_VII_of_France	parent	Adelaide_of_Maurienne
Philip_III_of_Spain	father	Philip_II_of_Spain
Catherine_of_Lancaster	type	Person
Isabella_I_of_Castile	spouse	Ferdinand_II_of_Aragon
Alfonso_XI_of_Castile	type	Person
Louis_XIII	type	Person
Louis_Duke_of_Orl_ans_1703_1752	spouse	Auguste_of_Bade_Baden
Isabella_of_Valois	type	Person
John_of_Eltham_Earl_of_Cornwall	type	Person
Margaret_of_Provence	gender	female
Robert_II_of_Scotland	child	Walter_Stewart_Earl_of_Atholl
Averardo_de_Medici	type	Person
Sancha_of_Aragon_Countess_of_Toulouse	type	Person
Charles_III_Duke_of_Savoy	spouse	Beatrice_of_Portugal_Duchess_of_Savoy
Sancho_IV_of_Castile	parent	Violant_of_Aragon
John_I_of_Portugal	child	Afonso_I_Duke_of_Braganza
Isabella_of_Portugal_Queen_of_Castile	parent	John_Constable_of_Portugal
Leopold_II_Holy_Roman_Emperor	predecessor	Joseph_II_Holy_Roman_Emperor
Gertrude_of_Hohenberg	gender	female
Afonso_III_of_Portugal	child	Urraca_Afonso
Robert_II_of_Scotland	child	Robert_III_of_Scotland
Hedwig_of_Bavaria	spouse	Welf_father_of_Judith
Maria_Teresa_Cybo_Malaspina_Duchess_of_Massa	spouse	Ercole_III_d_Este_Duke_of_Modena
Isabella_I_of_Castile	type	Person
James_Gordon_Jesuit	type	Person
Galeazzo_Maria_Sforza	type	Person
Henry_X_Duke_of_Bavaria	gender	male
Jacquetta_of_Luxembourg	father	Peter_I_Count_of_Saint_Pol
Maria_of_Naples	type	Person
Leopold_Duke_of_Lorraine	child	Francis_I_Holy_Roman_Emperor
Ferdinand_I_Holy_Roman_Emperor	child	Archduchess_Helena_of_Austria_1543_1574
Elizabeth_Gordon_Countess_of_Huntly	child	Patrick_Gordon_of_Auchindoun
Edmund_Tudor_1st_Earl_of_Richmond	type	Person
Berengaria_of_Barcelona	parent	Douce_I_Countess_of_Provence
Ecgberht_King_of_Wessex	hasSpouse	No
Margaret_of_the_Palatinate	father	Rupert_King_of_the_Romans
Louis_Jean_Marie_de_Bourbon_Duke_of_Penthi_vre	hasSpouse	Yes
Francis_II_Duke_of_Lorraine	spouse	Christina_of_Salm
Louis_I_of_Spain	predecessor	Philip_V_of_Spain
Marie_of_Luxembourg_Queen_of_France	name	Marie of Luxembourg
Joanna_of_Bavaria	type	Person
Anna_Gr_fin_D_nhoff	type	Person
Otto_William_Count_of_Burgundy	parent	Adalbert_of_Italy
Alice_Holland_Countess_of_Kent	mother	Eleanor_of_Lancaster
Violant_of_Hungary	parent	Andrew_II_of_Hungary
Adolphus_Frederick_II_Duke_of_Mecklenburg_Strelitz	hasSpouse	No
Francesco_I_de_Medici_Grand_Duke_of_Tuscany	successor	Ferdinando_I_de_Medici_Grand_Duke_of_Tuscany
Marie_Eleonore_of_Cleves	hasSpouse	Yes
Robert_King_of_Naples	type	Person
Maria_Luisa_of_Spain	child	Archduke_Louis_of_Austria
Philip_II_of_France	successor	Louis_VIII_of_France
Richard_Duke_of_Burgundy	hasSpouse	Yes
Rozala_of_Italy	type	Person
Blanche_of_Artois	spouse	Henry_I_of_Navarre
Charles_V_of_France	predecessor	John_II_of_France
Robert_I_of_France	gender	male
Agnes_of_France_Duchess_of_Burgundy	child	Louis_of_Burgundy
Giovanni_delle_Bande_Nere	mother	Caterina_Sforza
Louis_Duke_of_Orl_ans_1703_1752	predecessor	Philippe_II_Duke_of_Orl_ans
Sviatoslav_I	successor	Yaropolk_I_of_Kiev
Louis_XIV	successor	Anne_of_Austria
Henry_I_of_England	spouse	Matilda_of_Scotland
Louis_XV	child	Marie_Louise_of_France_1728_1733
Anne_of_Austria	spouse	Louis_XIII
Princess_Magdalena_Augusta_of_Anhalt_Zerbst	hasSpouse	Yes
Catherine_de_Medici	hasSpouse	Yes
Louis_Duke_of_Orl_ans_1703_1752	parent	Philippe_II_Duke_of_Orl_ans
Frederick_II_Duke_of_Brunswic_L_neburg	parent	Bernard_I_Duke_of_Brunswic_L_neburg
Cosimo_de_Medici	type	Person
John_of_Bohemia	child	Margaret_of_Bohemia_Duchess_of_Bavaria
Marie_Antoinette	hasSpouse	Yes
Joan_II_of_Navarre	successor	Charles_II_of_Navarre
William_Duke_of_Austria	predecessor	Leopold_III_Duke_of_Austria
Sancho_IV_of_Castile	gender	male
Clementia_of_Hungary	hasSpouse	Yes
Maredudd_ap_Tudur	parent	Tudur_ap_Goronwy
Conrad_I_of_Burgundy	mother	Bertha_of_Swabia
John_Count_of_Soissons_and_Enghien	type	Person
Henry_IV_of_England	successor	Henry_V_of_England
Joan_III_Countess_of_Burgundy	father	Philip_V_of_France
Charles_the_Fat	predecessor	Carloman_of_Bavaria
Rudolph_II_of_Burgundy	type	Person
Eleanor_of_Navarre	child	Jacques_de_Foix_Count_of_Montfort
Manuel_I_of_Portugal	predecessor	John_II_of_Portugal
Anne_of_Cyprus	child	Bona_of_Savoy
Landgravine_Elisabeth_Amalie_of_Hesse_Darmstadt	child	Johann_Wilhelm_Elector_Palatine
Henry_of_Bohemia	successor	John_of_Bohemia
Charlemagne	spouse	Hildegard_of_the_Vinzgau
Joan_of__vreux	parent	Louis_Count_of__vreux
Raymond_Berengar_of_Andria	type	Person
Hugh_Count_of_Vermandois	type	Person
Reginar_Longneck	hasSpouse	No
Louis_I_Duke_of_Bavaria	spouse	Ludmilla_of_Bohemia
Robert_II_of_Scotland	mother	Marjorie_Bruce
Archduchess_Catherine_Renata_of_Austria	type	Person
Nicolas_Duke_of_Merc_ur	father	Antoine_Duke_of_Lorraine
Godfrey_I_Count_of_Louvain	type	Person
Anne_Marie_d_Orl_ans	child	Maria_Luisa_Gabriella_of_Savoy
Maria_Carolina_of_Austria	type	Person
Marie_of_Brabant_Queen_of_France	mother	Adelaide_of_Burgundy_Duchess_of_Brabant
Gertrude_of_Flanders_Countess_of_Savoy	type	Person
Richard_Fitzalan_3rd_Earl_of_Arundel	hasSpouse	Yes
Pedro_Fern_ndez_de_Castro	type	Person
Charles_Martel	predecessor	Ragenfrid
Marie_of_Orl_ans_Viscountess_of_Narbonne	type	Person
Henry_IV_of_France	mother	Jeanne_d_Albret
Afonso_IV_of_Portugal	type	Person
Elizabeth_of_Austria_1436_1505	child	Sigismund_I_the_Old
Frederuna	type	Person
Henry_II_of_France	child	Louis_of_Valois
Frederick_II_Duke_of_Brunswic_L_neburg	gender	male
Fran_oise_Marie_de_Bourbon	father	Louis_XIV
Leonor_de_Alvim	type	Person
Catherine_of_Foix_Countess_of_Candale	hasSpouse	Yes
Berengaria_of_Barcelona	type	Person
Maredudd_ap_Tudur	parent	Marged_ferch_Tomos
Louise_de_Maisonblanche	type	Person
Anne_Marie_d_Orl_ans	spouse	Victor_Amadeus_II_of_Sardinia
Marie_of_Anjou	type	Person
John_II_Duke_of_Brittany	hasSpouse	Yes
Beatrice_of_Avesnes	type	Person
Mary_of_Hungary_Queen_of_Naples	child	Charles_Martel_of_Anjou
Louis_Count_of__vreux	parent	Marie_of_Brabant_Queen_of_France
Marie_Jos_phine_of_Savoy	spouse	Louis_XVIII
Robert_III_of_Scotland	gender	male
Catherine_of_Valois	father	Charles_VI_of_France
Elizabeth_Mure	type	Person
Alfonso_VII_of_Le_n_and_Castile	hasSpouse	Yes
Benedicta_Henrietta_of_the_Palatinate	mother	Anne_Gonzaga
Yolanda_Latin_Empress	parent	Margaret_I_Countess_of_Flanders
Sviatoslav_I	hasSpouse	Yes
Frederick_Prince_of_Wales	child	Prince_William_Henry_Duke_of_Gloucester_and_Edinburgh
Charles_Martel	parent	Alpaida
Eilika_of_Schweinfurt	type	Person
Agnes_of_Burgundy_Duchess_of_Bourbon	parent	Margaret_of_Bavaria
Antoinette_of_Bourbon	parent	Francis_Count_of_Vend_me
Louise_of_Savoy	parent	Philip_II_Duke_of_Savoy
William_XII_Count_of_Auvergne	hasSpouse	No
Elisabeth_Farnese	marriedTo	Maria_Amalia_of_Saxony
John_II_Duke_of_Brittany	child	Marie_of_Brittany_Countess_of_Saint_Pol
Louis_I_Duke_of_Bourbon	hasSpouse	Yes
Eleanor_of_Alburquerque	mother	Beatrice_of_Portugal_died_1381
Countess_Amalia_Katharina_of_Waldeck	hasSpouse	No
Maria_Amalia_of_Naples_and_Sicily	hasSpouse	Yes
Robert_III_of_Scotland	parent	Robert_II_of_Scotland
Marie_of_Valois_Prioress_of_Poissy	type	Person
Joan_Countess_of_Ponthieu	successor	John_I_Count_of_Aumale
Philippe_II_Duke_of_Orl_ans	hasSpouse	Yes
Herbert_II_Count_of_Vermandois	type	Person
Ramon_Berenguer_IV_Count_of_Barcelona	type	Person
Fernando_de_la_Cerda_1255_1275	type	Person
John_I_of_Portugal	father	Peter_I_of_Portugal
Boso_the_Elder	type	Person
Margaret_Holland_Duchess_of_Clarence	parent	Thomas_Holland_2nd_Earl_of_Kent
Henry_II_of_Castile	name	Henry II
Charles_X	hasSpouse	Yes
Joan_of_Acre	type	Person
Conrad_I_Count_of_Auxerre	type	Person
Ramon_Berenguer_II_Count_of_Barcelona	spouse	Maud_of_Apulia
Ren__of_Anjou	predecessor	Louis_III_of_Anjou
Joan_the_Lame	parent	Agnes_of_France_Duchess_of_Burgundy
Hugh_Count_of_Burgundy	father	John_Count_of_Chalon
Alice_of_Vergy	type	Person
Louise_Marie_Ad_la_de_de_Bourbon_Duchess_of_Orl_ans	parent	Maria_Teresa_Felicitas_d_Este
Maria_Theresa	child	Leopold_II_Holy_Roman_Emperor
Leonor_de_Alvim	hasSpouse	No
Matilda_of_Brandenburg_Duchess_of_Brunswic_L_neburg	type	Person
Maria_Christina_of_the_Two_Sicilies	type	Person
Caroline_Matilda_of_Great_Britain	type	Person
Charlemagne	successor	Bernard_of_Italy
Igor_of_Kiev	successor	Olga_of_Kiev
Catherine_of_Mayenne	type	Person
Fran_oise_Ath_na_s_de_Rochechouart_Marquise_de_Montespan	spouse	Louis_Henri_de_Pardaillan_de_Gondrin
Melisende_Queen_of_Jerusalem	type	Person
_thelweard_son_of_Alfred	type	Person
John_II_of_France	spouse	Bonne_of_Luxembourg
Charles_II_Archduke_of_Austria	predecessor	Ferdinand_I_Holy_Roman_Emperor
Eleanor_of_Castile	parent	Joan_Countess_of_Ponthieu
Philip_V_of_France	spouse	Joan_II_Countess_of_Burgundy
Elizabeth_Gordon_Countess_of_Huntly	hasSpouse	Yes
Alfonso_IX_of_Le_n	child	Ferdinand_of_Le_n_died_1214
Leopold_III_Duke_of_Austria	hasSpouse	Yes
James_I_Count_of_La_Marche	gender	male
Elisabeth_of_Nuremberg	parent	Elisabeth_of_Meissen
Kunigunde_of_Altdorf	type	Person
Margaret_of_Provence	child	Robert_Count_of_Clermont
Marie_Eleonore_of_Cleves	child	Duchess_Sophie_of_Prussia
Louis_Philippe_II_Duke_of_Orl_ans	parent	Louis_Philippe_I_Duke_of_Orl_ans
Pepin_the_Short	father	Charles_Martel
Louis_Philippe_I	type	Person
Maud_FitzJohn_Countess_of_Warwick	type	Person
Childeric_III	successor	Pepin_the_Short
James_I_Count_of_La_Marche	father	Louis_I_Duke_of_Bourbon
Philippa_of_Guelders	spouse	Ren__II_Duke_of_Lorraine
Christina_of_Lorraine	type	Person
Arthur_II_Duke_of_Brittany	parent	Beatrice_of_England
Prince_Philippe_Count_of_Paris	hasSpouse	Yes
Arthur_II_Duke_of_Brittany	parent	John_II_Duke_of_Brittany
Janus_of_Cyprus	type	Person
Ferdinand_II_of_Aragon	parent	John_II_of_Aragon
Victor_Amadeus_III_of_Sardinia	parent	Charles_Emmanuel_III_of_Sardinia
Claude_of_France	type	Person
Charles_V_Holy_Roman_Emperor	predecessor	Joanna_of_Castile
Ernest_Frederick_I_Duke_of_Saxe_Hildburghausen	hasSpouse	Yes
Louis_XVI	father	Louis_Dauphin_of_France_son_of_Louis_XV
Charles_Emmanuel_II_Duke_of_Savoy	father	Victor_Amadeus_I_Duke_of_Savoy
Pedro_Fern_ndez_de_Castro	hasSpouse	No
Henry_VI_of_England	hasSpouse	Yes
Paul_Scarron	type	Person
Constance_of_Arles	parent	William_I_of_Provence
Elisabeth_Farnese	type	Person
Violant_of_Bar	spouse	Louis_II_of_Anjou
James_III_of_Scotland	successor	James_IV_of_Scotland
Dirk_III_Count_of_Holland	father	Arnulf_Count_of_Holland
Christian_III_Count_Palatine_of_Zweibr_cken	spouse	Countess_Caroline_of_Nassau_Saarbr_cken
Amadeus_VIII_Duke_of_Savoy	successor	Louis_Duke_of_Savoy
Charles_the_Fat	gender	male
Charles_Duke_of_Orl_ans	gender	male
Lorenzo_the_Elder	hasSpouse	Yes
Louis_XV	child	Sophie_of_France_1734_1782
Charlotte_of_Bourbon_Queen_of_Cyprus	spouse	Janus_of_Cyprus
Baldwin_II_Count_of_Hainaut	gender	male
Louis_Philippe_I	successor	French_Revolution_of_1848
Robert_II_of_Scotland	predecessor	David_II_of_Scotland
Charles_X	predecessor	Louis_XVIII
Robert_I_Duke_of_Burgundy	spouse	Ermengarde_of_Anjou_Duchess_of_Burgundy
John_IV_Duke_of_Brittany	child	John_V_Duke_of_Brittany
Gertrude_of_Saxony	spouse	Floris_I_Count_of_Holland
Archduke_Maximilian_Francis_of_Austria	type	Person
James_II_of_Scotland	hasSpouse	Yes
Matilda_II_Countess_of_Boulogne	spouse	Afonso_III_of_Portugal
Henry_Count_of_Portugal	father	Henry_son_of_Robert_I_of_Burgundy
Charlotte_of_Bourbon_Queen_of_Cyprus	mother	Catherine_of_Vend_me
Rudolph_II_of_Burgundy	mother	Guilla_of_Provence
Willa_of_Tuscany	parent	Willa_of_Burgundy
Margaret_of_Provence	child	Peter_I_Count_of_Alen_on
Polyxena_of_Hesse_Rotenburg	type	Person
Igor_of_Kiev	predecessor	Oleg_of_Novgorod
Elizabeth_Woodville	child	Catherine_of_York
Louis_II_of_Anjou	child	Marie_of_Anjou
Ferdinand_I_Holy_Roman_Emperor	child	Elizabeth_of_Austria_1526_1545
Igor_of_Kiev	type	Person
Charles_II_of_Navarre	predecessor	Joan_II_of_Navarre
Matilda_of_Frisia	spouse	Henry_I_of_France
Theodoric_II_Duke_of_Lorraine	parent	Gerard_Duke_of_Lorraine
Eleanor_of_Portugal_Holy_Roman_Empress	spouse	Frederick_III_Holy_Roman_Emperor
Eadgifu_of_Wessex	gender	female
Odo_I_Count_of_Orl_ans	type	Person
Henry_the_Middle_Duke_of_Brunswic_L_neburg	spouse	Anna_von_Campe
Isabella_of_France_Queen_of_Navarre	type	Person
Sancha_of_Castile_Queen_of_Aragon	spouse	Alfonso_II_of_Aragon
Edward_III_of_England	spouse	Philippa_of_Hainault
Maria_Josepha_of_Austria	child	Maria_Josepha_of_Saxony_Dauphine_of_France
Polissena_Ruffo	type	Person
Fulk_I_Count_of_Anjou	type	Person
Victor_Amadeus_III_of_Sardinia	parent	Polyxena_of_Hesse_Rotenburg
Raymond_of_Burgundy	predecessor	Nuno_Mendes_count
Pepin_of_Herstal	hasSpouse	Yes
Joan_II_Countess_of_Burgundy	predecessor	Otto_IV_Count_of_Burgundy
William_Duke_of_J_lich_Cleves_Berg	hasSpouse	Yes
Sancho_I_of_Portugal	child	Infanta_Branca_Lady_of_Guadalajara
Odo_III_Duke_of_Burgundy	spouse	Theresa_of_Portugal_Countess_of_Flanders
George_Duke_of_Brunswic_Calenberg	type	Person
Elisabeth_Christine_of_Brunswic_Wolfenb_ttel	type	Person
James_of_Avesnes	type	Person
Hugh_IV_Duke_of_Burgundy	type	Person
Hieronymus_son_of_Charles_Martel	type	Person
Emanuel_Filibert_of_Savoy	type	Person
Louise_Ad_la_de_d_Orl_ans	type	Person
Carlos_Prince_of_Asturias	type	Person
Berengar_II_of_Italy	gender	male
Albert_III_Count_of_Habsburg	hasSpouse	No
Archduchess_Anna_of_Austria	gender	female
Alfonso_II_Count_of_Provence	spouse	Garsenda_Countess_of_Forcalquier
Gertrude_of_Dagsburg	spouse	Theobald_I_of_Navarre
Charles_VIII_of_France	hasSpouse	Yes
Beatrice_of_England	mother	Eleanor_of_Provence
Bianca_Maria_Visconti	type	Person
Elizabeth_of_Austria_1436_1505	child	Anna_Jagiellon_Duchess_of_Pomerania
John_II_of_Castile	hasSpouse	Yes
Charles_the_Fat	predecessor	Carloman_II
Bernard_I_Duke_of_Brunswic_L_neburg	parent	Magnus_II_Duke_of_Brunswic_L_neburg
George_II_of_Great_Britain	successor	George_III
Louis_VIII_of_France	successor	Louis_IX_of_France
John_Stewart_1st_Earl_of_Lennox	type	Person
Rudolf_I_of_Germany	child	Hedwig_of_Habsburg
Eleanor_of_England_Queen_of_Castile	gender	female
Germaine_of_Foix	spouse	Ferdinand_II_of_Aragon
Charles_Emmanuel_III_of_Sardinia	parent	Anne_Marie_d_Orl_ans
Otto_II_Count_of_Habsburg	gender	male
Ferdinand_II_of_Aragon	predecessor	John_II_of_Aragon
Joan_of_Valois_Countess_of_Hainaut	spouse	William_I_Count_of_Hainaut
Louis_Philippe_I_Duke_of_Orl_ans	spouse	Madame_de_Montesson
Maria_Anna_of_Bavaria_born_1551	father	Albert_V_Duke_of_Bavaria
Francesco_III_d_Este_Duke_of_Modena	hasSpouse	Yes
Theobald_II_Count_of_Champagne	gender	male
Baldwin_II_Count_of_Hainaut	spouse	Ida_Countess_of_Hainaut
Countess_Caroline_of_Nassau_Saarbr_cken	spouse	Christian_III_Count_Palatine_of_Zweibr_cken
Margaret_of_Valois_Angoul_me	mother	Louise_of_Savoy
Simon_I_Duke_of_Lorraine	hasSpouse	Yes
Theobald_of_Arles	hasSpouse	No
Bertha_of_Swabia	hasSpouse	Yes
Maria_of_Austria_Duchess_of_J_lich_Cleves_Berg	name	
Otto_II_Count_of_Chiny	type	Person
John_IV_Duke_of_Brittany	type	Person
A_nor_de_Ch_tellerault	parent	Dangereuse_de_l_Isle_Bouchard
Berengar_I_of_Italy	successor	Rudolph_II_of_Burgundy
Yaroslav_the_Wise	parent	Rogneda_of_Polotsk
Stephen_Count_of_Blois	gender	male
Sancho_II_of_Portugal	successor	Afonso_III_of_Portugal
Louis_the_Stammerer	child	Louis_III_of_France
Dirk_II_Count_of_Holland	type	Person
James_I_of_Aragon	spouse	Violant_of_Hungary
Matilda_of_Savoy_Queen_of_Portugal	type	Person
Constance_of_Castile	mother	Berengaria_of_Barcelona
Robert_II_Count_of_Artois	hasSpouse	Yes
Madeleine_de_La_Tour_d_Auvergne	type	Person
Bonne_of_Luxembourg	mother	Elizabeth_of_Bohemia_1292_1330
Catherine_of_Foix_Countess_of_Candale	parent	Eleanor_of_Navarre
Vladimir_the_Great	spouse	Rogneda_of_Polotsk
Urraca_of_Castile_Queen_of_Portugal	spouse	Afonso_II_of_Portugal
Francis_I_Holy_Roman_Emperor	child	Archduchess_Maria_Josepha_of_Austria
Magdalena_Sibylla_of_Saxe_Weissenfels	type	Person
Albert_II_Duke_of_Austria	child	Frederick_III_Duke_of_Austria
Amicie_de_Courtenay	type	Person
Henry_VII_Holy_Roman_Emperor	predecessor	Conrad_IV_of_Germany
William_VIII_Duke_of_Aquitaine	hasSpouse	Yes
Agatha_wife_of_Edward_the_Exile	spouse	Edward_the_Exile
Robert_I_of_France	spouse	Aelis
Louis_Auguste_Duke_of_Maine	type	Person
Alfonso_II_of_Aragon	child	Sancha_of_Aragon_Countess_of_Toulouse
Princess_Augusta_of_Saxe_Gotha	mother	Princess_Magdalena_Augusta_of_Anhalt_Zerbst
Maria_Anna_of_Bavaria_born_1551	child	Archduchess_Maria_Maddalena_of_Austria
Marie_of_Luxembourg_Countess_of_Vend_me	mother	Margaret_of_Savoy_Countess_of_Saint_Pol
Charles_Martel	parent	Pepin_of_Herstal
Anne_of_Cyprus	parent	Charlotte_of_Bourbon_Queen_of_Cyprus
Ingegerd_Olofsdotter_of_Sweden	child	Anastasia_of_Kiev
Elisabeth_of_Meissen	type	Person
Frederick_IV_Duke_of_Brunswic_L_neburg	type	Person
Ramon_Berenguer_III_Count_of_Barcelona	type	Person
Maria_Josepha_of_Austria	child	Princess_Maria_Christina_of_Saxony_1735_1782
Louis_Duke_of_Savoy	parent	Amadeus_VIII_Duke_of_Savoy
Canute_Lavard	type	Person
Otto_III_Duke_of_Bavaria	type	Person
Luitgarde_of_Vermandois	gender	female
Louis_I_Duke_of_Bourbon	mother	Beatrice_of_Burgundy_Lady_of_Bourbon
Johann_Adolf_of_Saxe_Gotha_Altenburg	type	Person
Princess_Elisabeth_Albertine_of_Saxe_Hildburghausen	child	Charles_II_Grand_Duke_of_Mecklenburg_Strelitz
Radbot_of_Klettgau	hasSpouse	No
Albert_I_of_Germany	child	Henry_the_Friendly
Eleanor_of_Navarre	child	Gaston_Prince_of_Viana
Ferdinand_I_of_the_Two_Sicilies	child	Maria_Theresa_of_Naples_and_Sicily
Francis_Hyacinth_Duke_of_Savoy	type	Person
Edward_I_of_England	hasSpouse	Yes
Richeza_of_Denmark	type	Person
Clemence_of_Austria	mother	Gertrude_of_Hohenberg
Barbara_Jagiellon	type	Person
Elisabeth_Farnese	gender	female
Barbara_Jagiellon	mother	Elizabeth_of_Austria_1436_1505
Geoffrey_Plantagenet_Count_of_Anjou	child	Geoffrey_Count_of_Nantes
Ren__of_Anjou	child	Margaret_of_Anjou
Marozia	successor	Willa_of_Burgundy
Sophia_Dorothea_of_Celle	marriedTo	George_I_of_Great_Britain
Napoleon_III	parent	Louis_Bonaparte
Charles_VII_of_France	gender	male
Margaret_of_Valois	gender	female
Francis_II_Duke_of_Brittany	mother	Margaret_Countess_of_Vertus
Anna_Sophia_of_Prussia	hasSpouse	No
Maud_Chaworth	mother	Isabella_de_Beauchamp
Pepin_of_Herstal	successor	Charles_Martel
Berengar_II_of_Italy	parent	Gisela_of_Friuli
Marie_Antoinette	spouse	Louis_XVI
Edward_II_of_England	child	Eleanor_of_Woodstock
Hugh_III_Duke_of_Burgundy	gender	male
Adolf_King_of_the_Romans	successor	Albert_I_of_Germany
William_VIII_Duke_of_Aquitaine	spouse	Hildegarde_of_Burgundy
Philip_the_Bold	successor	John_the_Fearless
Theobald_III_Count_of_Blois	spouse	Gersende_of_Maine
Stephen_V_of_Hungary	hasSpouse	Yes
Richard_Woodville_1st_Earl_Rivers	spouse	Jacquetta_of_Luxembourg
Ecgberht_King_of_Wessex	parent	Ealhmund_of_Kent
Archduke_Ferdinand_Karl_Joseph_of_Austria_Este	type	Person
John_George_I_Elector_of_Saxony	type	Person
Margaret_of_Foix	type	Person
Isabella_de_Beauchamp	mother	Maud_FitzJohn_Countess_of_Warwick
Louis_IX_Landgrave_of_Hesse_Darmstadt	type	Person
Francis_I_Duke_of_Lorraine	spouse	Christina_of_Denmark
Louis_IV_Holy_Roman_Emperor	predecessor	Henry_VII_Holy_Roman_Emperor
Louis_IV_Holy_Roman_Emperor	child	Otto_V_Duke_of_Bavaria
Charles_Ferdinand_Duke_of_Berry	parent	Maria_Theresa_of_Savoy
Henry_the_Fowler	child	Gerberga_of_Saxony
Sibylla_of_Anjou	child	Philip_I_Count_of_Flanders
Elisabeth_Christine_of_Brunswic_Wolfenb_ttel	parent	Princess_Christine_Louise_of_Oettinge_Oettingen
Piero_di_Cosimo_de_Medici	type	Person
Louis_IV_of_France	parent	Eadgifu_of_Wessex
Blanche_of_Castile	child	Louis_IX_of_France
Adelaide_of_Maurienne	child	Philip_of_France_1116_1131
Louis_IV_of_France	father	Charles_the_Simple
Maud_Chaworth	spouse	Henry_3rd_Earl_of_Lancaster
Duke_Charles_Louis_Frederick_of_Mecklenburg	child	Charles_II_Grand_Duke_of_Mecklenburg_Strelitz
Louis_X_of_France	successor	John_I_of_France
Giovanni_di_Bicci_de_Medici	spouse	Piccarda_Bueri
Haziga_of_Diessen	spouse	Otto_I_Count_of_Scheyern
Prince_Ferdinand_Duke_of_Montpensier	predecessor	Antoine_Duke_of_Montpensier
Beatrice_of_Castile_1242_1303	spouse	Afonso_III_of_Portugal
John_II_of_Aragon	name	John II
Ernest_I_Duke_of_Brunswic_L_neburg	successor	William_the_Younger_Duke_of_Brunswic_L_neburg
Elizabeth_of_Austria_1436_1505	child	Barbara_Jagiellon
Charles_the_Bold	type	Person
Albert_I_of_Germany	child	Elisabeth_of_Austria_Duchess_of_Lorraine
Antoine_Philippe_Duke_of_Montpensier	type	Person
Matilda_of_B_thune	type	Person
Maria_Theresa_of_Savoy	child	Louis_Antoine_Duke_of_Angoul_me
Maria_Christina_of_the_Two_Sicilies	child	Infanta_Luisa_Fernanda_Duchess_of_Montpensier
Guy_III_of_Spoleto	predecessor	Charles_the_Fat
Albert_Frederick_Duke_of_Prussia	spouse	Marie_Eleonore_of_Cleves
Leopold_II_Holy_Roman_Emperor	child	Archduke_Charles_Duke_of_Teschen
Charles_the_Simple	hasSpouse	Yes
Louis_IV_of_France	gender	male
Maria_Beatrice_d_Este_Duchess_of_Massa	predecessor	Maria_Teresa_Cybo_Malaspina_Duchess_of_Massa
Francis_I_Holy_Roman_Emperor	child	Maria_Christina_Duchess_of_Teschen
Ingeborg_of_Denmark_Queen_of_France	gender	female
Matthias_I_Duke_of_Lorraine	parent	Simon_I_Duke_of_Lorraine
Simon_I_Duke_of_Lorraine	mother	Hedwig_of_Formbach
Nicholas_Francis_Duke_of_Lorraine	parent	Francis_II_Duke_of_Lorraine
Leopold_II_Holy_Roman_Emperor	father	Francis_I_Holy_Roman_Emperor
Catherine_of_Vend_me	gender	female
Olof_Sk_tkonung	spouse	Estrid_of_the_Obotrites
Theobald_I_Count_of_Blois	type	Person
Marie_of_Brabant_Queen_of_France	father	Henry_III_Duke_of_Brabant
Louis_XIV	successor	Louis_XV
Charles_III_of_Spain	name	Charles III
Lambert_II_Count_of_Louvain	parent	Lambert_I_Count_of_Louvain
George_III	child	Princess_Elizabeth_of_the_United_Kingdom
James_I_of_Aragon	hasSpouse	Yes
Philip_of_Castile	type	Person
Louis_III_of_France	hasSpouse	No
James_II_of_Majorca	type	Person
Maximilian_II_Holy_Roman_Emperor	mother	Anne_of_Bohemia_and_Hungary
Charles_the_Simple	spouse	Eadgifu_of_Wessex
_lffl_d_wife_of_Edward_the_Elder	child	Edwin_son_of_Edward_the_Elder
Napol_on_Prince_Imperial	type	Person
Anna_Eleonore_of_Hesse_Darmstadt	type	Person
Philip_II_of_Spain	child	Philip_III_of_Spain
Philip_III_of_Spain	predecessor	Philip_II_of_Spain
Gerard_de_Bouzonville	hasSpouse	No
Philip_I_Count_of_Auvergne	type	Person
Liudolf_Margrave_of_Frisia	parent	Brun_I_Count_of_Brunswick
Muzio_Attendolo_Sforza	type	Person
Elizabeth_of_York	hasSpouse	Yes
Eberhard_II_Count_of_W_rttemberg	type	Person
John_I_of_Portugal	child	Prince_Henry_the_Navigator
Charles_Martel	successor	Carloman_mayor_of_the_palace
Vladimir_the_Great	child	Boris_and_Gleb
Amaury_II_de_Montfort	predecessor	Simon_I_de_Montfort
William_IX_Duke_of_Aquitaine	parent	Hildegarde_of_Burgundy
Ferdinand_III_of_Castile	child	Manuel_of_Castile
William_I_Count_of_Burgundy	type	Person
Blanca_of_Navarre_Queen_of_Castile	hasSpouse	Yes
Philip_VI_of_France	hasSpouse	Yes
Philip_V_of_Spain	hasSpouse	Yes
John_II_Duke_of_Brittany	spouse	Beatrice_of_England
Alice_Holland_Countess_of_Kent	gender	female
Eckhard_I_Count_of_Scheyern	gender	male
Mary_of_Hungary_Queen_of_Naples	father	Stephen_V_of_Hungary
Maria_of_Aragon_Queen_of_Portugal	child	Ferdinand_of_Portugal_Duke_of_Guarda
Margaret_of_Burgundy_Queen_of_France	spouse	Kingdom_of_Navarre
Hugh_of_Italy	mother	Bertha_daughter_of_Lothair_II
John_II_of_France	hasSpouse	Yes
John_King_of_England	child	Henry_III_of_England
Marie_of_Luxembourg_Countess_of_Vend_me	gender	female
Princess_Mary_of_Great_Britain	type	Person
Ernest_Augustus_King_of_Hanover	type	Person
Begga	type	Person
Elias_I_Count_of_Maine	type	Person
Lixheim	type	Person
Mary_of_Waltham	spouse	John_IV_Duke_of_Brittany
Louis_the_Pious	parent	Charlemagne
Odo_III_Duke_of_Burgundy	predecessor	Hugh_III_Duke_of_Burgundy
Charles_VII_of_France	child	Charles_of_Valois_Duke_of_Berry
John_I_Duke_of_Brittany	predecessor	Peter_II_Count_of_Savoy
Joan_Beaufort_Queen_of_Scots	parent	John_Beaufort_1st_Earl_of_Somerset
John_IV_Duke_of_Brittany	predecessor	John_of_Montfort
Anne_of_Bohemia_and_Hungary	child	Elizabeth_of_Austria_1526_1545
John_of_Montfort	father	Arthur_II_Duke_of_Brittany
John_II_of_France	parent	Joan_the_Lame
Fulk_King_of_Jerusalem	father	Fulk_IV_Count_of_Anjou
Ren__II_Duke_of_Lorraine	hasSpouse	Yes
Mar_a_Isabella_of_Spain	child	Teresa_Cristina_of_the_Two_Sicilies
Charles_Emmanuel_III_of_Sardinia	child	Victor_Amadeus_III_of_Sardinia
Charles_Emmanuel_I_Duke_of_Savoy	hasSpouse	Yes
Adolphus_Frederick_I_Duke_of_Mecklenburg_Schwerin	spouse	Anna_Maria_of_Ostfriesland
Charles_Duke_of_Orl_ans	spouse	Marie_of_Cleves_Duchess_of_Orl_ans
Henry_VI_Count_of_Luxembourg	mother	Margaret_of_Bar
John_Duke_of_Berry	type	Person
Isabella_of_Valois_Duchess_of_Bourbon	spouse	Peter_I_Duke_of_Bourbon
John_of_Gaunt	hasSpouse	Yes
Mary_of_Hungary_Queen_of_Naples	child	Peter_Tempesta
Charles_Emmanuel_IV_of_Sardinia	type	Person
Eleanor_of_Normandy	spouse	Baldwin_IV_Count_of_Flanders
Philippe_II_Duke_of_Orl_ans	spouse	Fran_oise_Marie_de_Bourbon
Rudolph_III_of_Burgundy	type	Person
Theobald_I_Duke_of_Lorraine	predecessor	Frederick_II_Duke_of_Lorraine
Urraca_of_Castile_Queen_of_Portugal	type	Person
John_Duke_of_Touraine	type	Person
Eleanor_of_Alburquerque	gender	female
Adelaide_of_Holland	spouse	John_I_Count_of_Hainaut
Archduchess_Eleanor_of_Austria	type	Person
Baldwin_I_Margrave_of_Flanders	type	Person
Anna_Maria_of_Ostfriesland	mother	Anna_of_Holstei_Gottorp
Isabella_of_France	father	Philip_IV_of_France
Philip_of_France_1116_1131	gender	male
Maria_Carolina_of_Austria	child	Maria_Clotilde_of_Naples_and_Sicily
Marie_Louise_Duchess_of_Parma	spouse	Charles_Ren__de_Bombelles
Nuno_Mendes_count	successor	Raymond_of_Burgundy
Theobald_I_of_Navarre	spouse	Agnes_of_Beaujeu
Eleanor_of_Aquitaine	spouse	Louis_VII_of_France
Bivin_of_Gorze	type	Person
Duchess_Gustave_Caroline_of_Mecklenburg_Strelitz	type	Person
Charles_II_of_Navarre	type	Person
Louis_the_German	child	Charles_the_Fat
Edward_I_of_England	child	Joan_of_Acre
Adelaide_of_Paris	parent	Adalard_of_Paris
Robert_II_Count_of_Dreux	father	Robert_I_Count_of_Dreux
Floris_I_Count_of_Holland	gender	male
Elisabeth_of_Swabia	spouse	Ferdinand_III_of_Castile
Francis_II_Holy_Roman_Emperor	child	Ferdinand_I_of_Austria
Hugh_Capet	mother	Hedwig_of_Saxony
Charles_Duke_of_Vend_me	child	Francis_Count_of_Enghien
Robert_I_of_France	parent	Adelaide_of_Tours
Maria_Beatrice_of_Savoy	parent	Maria_Theresa_of_Austria_Este_Queen_of_Sardinia
Adela_of_Champagne	hasSpouse	Yes
Ragenfrid	type	Person
Charles_Count_of_Angoul_me	spouse	Louise_of_Savoy
Ermengarde_Countess_of_Maine	spouse	Fulk_King_of_Jerusalem
Hedwig_of_Bavaria	parent	Isambart
Theobald_I_Duke_of_Lorraine	type	Person
Eleanor_of_Lancaster	parent	Maud_Chaworth
Countess_Palatine_Caroline_of_Zweibr_cken	hasSpouse	Yes
Bouchard_IV_of_Avesnes	gender	male
Piero_di_Cosimo_de_Medici	hasSpouse	Yes
Cosimo_I_de_Medici_Grand_Duke_of_Tuscany	spouse	Camilla_Martelli
Burkhard_V_Count_of_Hohenberg	type	Person
Henry_VI_of_England	type	Person
Charlemagne	hasSpouse	Yes
Judith_of_Bavaria_died_843	spouse	Louis_the_Pious
Blanche_of_Castile	parent	Alfonso_VIII_of_Castile
Frederick_Prince_of_Wales	child	Prince_Edward_Duke_of_York_and_Albany
Frederick_Prince_of_Wales	child	Princess_Augusta_of_Great_Britain
Isabella_Duchess_of_Lorraine	predecessor	Charles_II_Duke_of_Lorraine
Joan_of_France_Duchess_of_Bourbon	type	Person
Dulce_of_Le_n	type	Person
Berenguer_Ramon_I_Count_of_Barcelona	mother	Ermesinde_of_Carcassonne
Louis_V_of_France	parent	Emma_of_Italy
Isabella_de_Beauchamp	gender	female
Robert_II_of_Scotland	hasSpouse	Yes
Princess_Louise_of_Hesse_Darmstadt_1757_1830	hasSpouse	Yes
Giovanni_di_Bicci_de_Medici	hasSpouse	Yes
Peter_of_Courtenay_Lord_of_Conches	parent	Robert_of_Courtenay_Lord_of_Champignelles
Maria_Theresa	predecessor	Charles_VII_Holy_Roman_Emperor
Marie_Eleonore_of_Cleves	child	Marie_of_Prussia_Margravine_of_Brandenburg_Bayreuth
Charlotte_Agla__d_Orl_ans	child	Maria_Teresa_Felicitas_d_Este
Fernando_Mar_a_Mu_oz_y_Borb_n_2nd_Duke_of_Taranc_n	type	Person
Elisabeth_of_Carinthia_Queen_of_the_Romans	type	Person
Catherine_of_Foix_Countess_of_Candale	mother	Eleanor_of_Navarre
Joanna_of_Austria_Grand_Duchess_of_Tuscany	parent	Anne_of_Bohemia_and_Hungary
Afonso_III_of_Portugal	child	Sancha_of_Portugal_born_1264
Charles_Duke_of_Lower_Lorraine	type	Person
Eleanor_of_Castile	hasSpouse	Yes
Tello_Alfonso	type	Person
Frederick_of_Naples	type	Person
Matilda_of_Brabant_Countess_of_Artois	type	Person
John_I_Duke_of_Lorraine	spouse	Eberhard_II_Count_of_W_rttemberg
Ferdinand_Duke_of_Viseu	parent	Edward_King_of_Portugal
Odo_I_Count_of_Blois	type	Person
Gian_Galeazzo_Sforza	type	Person
Vladimir_the_Great	father	Sviatoslav_I
Philip_III_of_Navarre	predecessor	Charles_IV_of_France
Margaret_I_Countess_of_Flanders	mother	Sibylla_of_Anjou
Louis_XIII	child	Philippe_I_Duke_of_Orl_ans
Anne_of_Foix_Candale	hasSpouse	Yes
Gisela_of_Burgundy_Marchioness_of_Montferrat	gender	female
Joanna_of_Austria_Grand_Duchess_of_Tuscany	child	Marie_de_Medici
Louis_VIII_of_France	child	Isabelle_of_France_saint
Louis_Count_of_Vend_me	successor	John_VIII_Count_of_Vend_me
Duke_George_Augustus_of_Mecklenburg	type	Person
Charles_III_of_Spain	predecessor	Antonio_Farnese_Duke_of_Parma
Diogo_Duke_of_Viseu	type	Person
Empress_Matilda	spouse	Geoffrey_Plantagenet_Count_of_Anjou
Matthias_I_Duke_of_Lorraine	type	Person
Louis_Philippe_I_Duke_of_Orl_ans	predecessor	Louis_Duke_of_Orl_ans_1703_1752
Alfonso_VII_of_Le_n_and_Castile	successor	Sancho_III_of_Castile
Alfonso_II_Count_of_Provence	parent	Alfonso_II_of_Aragon
Margaret_of_Artois	type	Person
Beatriz_Pereira_de_Alvim	parent	Nuno__lvares_Pereira
Marie_Antoinette	child	Louis_XVII
Maria_Teresa_Felicitas_d_Este	child	Vincent_de_Bourbon_Count_of_Guingamp
Eleanor_of_Aquitaine	father	William_X_Duke_of_Aquitaine
Princess_Maria_Antonia_of_Naples_and_Sicily	type	Person
Willa_of_Burgundy	hasSpouse	Yes
Werner_II_Count_of_Habsburg	hasSpouse	No
William_I_Count_of_Hainaut	spouse	Joan_of_Valois_Countess_of_Hainaut
Archduchess_Maria_Johanna_Gabriela_of_Austria	type	Person
Lambert_I_Count_of_Louvain	spouse	Gerberga_of_Lower_Lorraine
Adela_of_Champagne	spouse	Louis_VII_of_France
William_IV_Duke_of_Aquitaine	gender	male
Joan_of_Valois_Countess_of_Hainaut	type	Person
Humbert_II_Count_of_Savoy	spouse	Gisela_of_Burgundy_Marchioness_of_Montferrat
Victor_Amadeus_I_Duke_of_Savoy	child	Princess_Luisa_Cristina_of_Savoy
Francis_II_Duke_of_Lorraine	mother	Claude_of_France_1547_1575
Carloman_of_Bavaria	type	Person
Ferdinand_I_of_Aragon	child	Maria_of_Aragon_Queen_of_Castile
Ferdinand_II_of_Le_n	spouse	Teresa_Fern_ndez_de_Traba
Odo_I_Count_of_Blois	gender	male
Maria_Beatrice_d_Este_Duchess_of_Massa	child	Maria_Ludovika_of_Austria_Este
Antoinette_of_Bourbon	child	Louis_I_Cardinal_of_Guise
Afonso_III_of_Portugal	successor	Denis_of_Portugal
Ermentrude_of_Orl_ans	gender	female
Matthew_Count_of_Boulogne	type	Person
Frederick_II_Duke_of_Lorraine	type	Person
_thelstan	type	Person
Leopold_Duke_of_Lorraine	gender	male
Reginald_I_Count_of_Burgundy	hasSpouse	Yes
Ethelinde_of_Northeim	type	Person
Peter_I_Count_of_Urgell	type	Person
Charles_VI_of_France	successor	Charles_VII_of_France
Marie__milie_de_Joly_de_Choin	spouse	Louis_Dauphin_of_France_son_of_Louis_XIV
Maria_of_Austria_Holy_Roman_Empress	spouse	Maximilian_II_Holy_Roman_Emperor
Sophia_of_Saxe_Weissenfels_Princess_of_Anhalt_Zerbst	parent	Augustus_Duke_of_Saxe_Weissenfels
Oberto_II_Margrave_of_Milan	type	Person
Frederick_V_Burgrave_of_Nuremberg	type	Person
William_the_Younger_Duke_of_Brunswic_L_neburg	child	Sophie_of_Brunswic_L_neburg
Afonso_IV_of_Portugal	child	Maria_of_Portugal_Queen_of_Castile
John_I_Count_of_La_Marche	parent	James_I_Count_of_La_Marche
Bertha_of_Burgundy	parent	Conrad_I_of_Burgundy
Radbot_of_Klettgau	type	Person
Louis_I_of_Brzeg	type	Person
Joan_I_of_Navarre	successor	Philip_IV_of_France
Theobald_II_Duke_of_Lorraine	parent	Frederick_III_Duke_of_Lorraine
Matilda_of_Saxony_countess_of_Flanders	gender	female
Mary_Tudor_Queen_of_France	hasSpouse	Yes
Afonso_III_of_Portugal	father	Afonso_II_of_Portugal
Eleanor_of_Aquitaine	type	Person
Joan_II_of_Navarre	mother	Margaret_of_Burgundy_Queen_of_France
Charles_VI_of_France	parent	Joanna_of_Bourbon
Blanche_of_Brittany	mother	Beatrice_of_England
Marie_Duchess_of_Auvergne	successor	Agnes_of_Burgundy_Duchess_of_Bourbon
Philip_V_of_France	hasSpouse	Yes
Wilhelmine_Amalie_of_Brunswick	mother	Benedicta_Henrietta_of_the_Palatinate
Guillaume_de_Montfort_of_Hainaut	type	Person
Philip_II_Duke_of_Savoy	successor	Philibert_II_Duke_of_Savoy
Bernab__Visconti	type	Person
Joanna_II_of_Naples	type	Person
Peter_I_Duke_of_Brittany	father	Robert_II_Count_of_Dreux
Eleanor_of_Provence	parent	Beatrice_of_Savoy
Charlotte_of_Mecklenburg_Strelitz	child	Prince_Edward_Duke_of_Kent_and_Strathearn
Margaret_of_Foix	spouse	Richard_Count_of__tampes
Eleanor_of_Lancaster	father	Henry_3rd_Earl_of_Lancaster
Magdalene_Sibylle_of_Prussia	type	Person
Charles_V_of_France	successor	Charles_VI_of_France
Francis_I_of_France	child	Margaret_of_Valois_Duchess_of_Berry
Maria_Luisa_of_Parma	type	Person
Prince_Philippe_Duke_of_Orl_ans_1869_1926	type	Person
Edward_King_of_Portugal	type	Person
Louis_Antoine_Duke_of_Angoul_me	successor	Henri_Count_of_Chambord
Alfred_the_Great	predecessor	_thelred_I_King_of_Wessex
Bernard_of_Gothia	successor	Wilfred_the_Hairy
Albert_IV_Count_of_Habsburg	parent	Rudolf_II_Count_of_Habsburg
Rudolf_I_of_Germany	successor	Adolf_King_of_the_Romans
Archduchess_Maria_Clementina_of_Austria	mother	Maria_Luisa_of_Spain
Beatrice_of_England	father	Henry_III_of_England
Mahaut_of_Ch_tillon	type	Person
Giovanni_de_Medici_cardinal	type	Person
Joan_of__vreux	mother	Margaret_of_Artois
Richardis	type	Person
Beatrice_of_Provence	type	Person
Isabel_of_Barcelos	hasSpouse	Yes
Jasper_Tudor	type	Person
Dirk_II_Count_of_Holland	predecessor	Dirk_I_Count_of_Holland
Beatrice_of_Castile_1293_1359	type	Person
Joan_Countess_of_Ponthieu	parent	Marie_Countess_of_Ponthieu
Louis_XI	parent	Charles_VII_of_France
Francis_Duke_of_Anjou	type	Person
John_I_of_Castile	predecessor	Henry_II_of_Castile
Philip_III_of_Navarre	father	Louis_Count_of__vreux
Berengar_II_of_Italy	child	Rozala_of_Italy
Eberhard_II_Count_of_W_rttemberg	spouse	John_I_Duke_of_Lorraine
Hugh_IV_Duke_of_Burgundy	predecessor	Odo_III_Duke_of_Burgundy
Frederick_William_Duke_of_Mecklenburg_Schwerin	type	Person
Rudolf_IV_Duke_of_Austria	type	Person
Charlotte_of_Mecklenburg_Strelitz	child	Prince_Frederick_Duke_of_York_and_Albany
Henry_IV_of_Castile	type	Person
Francis_II_Holy_Roman_Emperor	parent	Leopold_II_Holy_Roman_Emperor
Alfonso_VIII_of_Castile	child	Blanche_of_Castile
Louis_Philippe_I	successor	Jacques_Charles_Dupont_de_l_Eure
Philip_I_of_Castile	child	Ferdinand_I_Holy_Roman_Emperor
Gisela_of_Burgundy_Marchioness_of_Montferrat	spouse	Humbert_II_Count_of_Savoy
Alix_Duchess_of_Brittany	successor	Peter_I_Duke_of_Brittany
Francesco_I_de_Medici_Grand_Duke_of_Tuscany	parent	Cosimo_I_de_Medici_Grand_Duke_of_Tuscany
Mahaut_Countess_of_Artois	type	Person
Fulk_IV_Count_of_Anjou	successor	Fulk_King_of_Jerusalem
Berengar_II_of_Italy	child	Guy_of_Ivrea
George_III	parent	Princess_Augusta_of_Saxe_Gotha
Violant_of_Hungary	father	Andrew_II_of_Hungary
Anne_of_Orl_ans_Abbess_of_Fontevraud	type	Person
Hortense_de_Beauharnais	gender	female
Baldwin_III_Count_of_Flanders	spouse	Matilda_of_Saxony_countess_of_Flanders
Philip_of_France_1116_1131	mother	Adelaide_of_Maurienne
John_Duke_of_Brunswic_L_neburg	type	Person
Catherine_of_Lorraine_Margravine_of_Bade_Baden	type	Person
Isabella_of_Bourbon	spouse	Charles_the_Bold
Eleanor_of_Castile	type	Person
Edward_I_of_England	predecessor	Henry_III_of_England
Charlotte_of_Mecklenburg_Strelitz	child	Princess_Elizabeth_of_the_United_Kingdom
Mary_of_Burgundy	predecessor	Charles_the_Bold
Elisabeth_of_Valois	type	Person
Ferdinand_IV_of_Castile	successor	Alfonso_XI_of_Castile
Beatrice_of_England	child	John_of_Brittany_Earl_of_Richmond
Maria_Antonia_Ferdinanda_of_Spain	father	Philip_V_of_Spain
Agnes_of_Rochlitz	type	Person
Sibylla_of_Anjou	spouse	Thierry_Count_of_Flanders
Robert_II_of_Scotland	spouse	Euphemia_de_Ross
Ferdinand_I_Holy_Roman_Emperor	mother	Joanna_of_Castile
Leopold_II_Holy_Roman_Emperor	type	Person
Catherine_de_Medici	mother	Madeleine_de_La_Tour_d_Auvergne
Philip_III_of_Navarre	parent	Louis_Count_of__vreux
Prince_Philippe_Count_of_Paris	gender	male
John_King_of_England	gender	male
Anne_of_Foix_Candale	parent	Catherine_of_Foix_Countess_of_Candale
Eckhard_I_Count_of_Scheyern	hasSpouse	No
Welf_I	type	Person
Sophia_of_Saxe_Weissenfels_Princess_of_Anhalt_Zerbst	parent	Anna_Maria_of_Mecklenburg_Schwerin
Dangereuse_de_l_Isle_Bouchard	father	Bartholomew_de_L_Isle_Bouchard
Blanche_of_Navarre_Queen_of_France	mother	Joan_II_of_Navarre
Robert_II_Count_of_Dreux	child	Peter_I_Duke_of_Brittany
Charles_IV_Duke_of_Alen_on	type	Person
Ferdinand_I_Holy_Roman_Emperor	parent	Joanna_of_Castile
Bertha_of_Burgundy	parent	Matilda_of_France
Louis_XVI	spouse	Charles_X
Ferdinand_I_of_the_Two_Sicilies	child	Maria_Cristina_of_Naples_and_Sicily
Baldwin_II_Count_of_Hainaut	mother	Richilde_Countess_of_Hainaut
Matilda_of_Habsburg	hasSpouse	Yes
Henry_I_Count_of_Champagne	parent	Theobald_II_Count_of_Champagne
Cosimo_de_Medici	gender	male
Landgravine_Elisabeth_Amalie_of_Hesse_Darmstadt	gender	female
Maria_Christina_of_the_Two_Sicilies	child	Mar_a_Cristina_Mu_oz_y_Borb_n_Marquise_of_la_Isabela
Blanche_of_Lancaster	type	Person
Charles_Cardinal_of_Lorraine	type	Person
Estrid_of_the_Obotrites	hasSpouse	Yes
Adelaide_of_Maurienne	child	Henry_of_France_Archbishop_of_Reims
Antonia_of_Savoy	type	Person
Frederick_I_Elector_of_Brandenburg	type	Person
Robert_II_of_Scotland	child	Walter_Stewart_Lord_of_Fife
Hugh_Capet	gender	male
Joan_II_Countess_of_Burgundy	parent	Mahaut_Countess_of_Artois
Gertrude_of_Flanders_Duchess_of_Lorraine	spouse	Theodoric_II_Duke_of_Lorraine
Philip_Duke_of_Parma	hasSpouse	Yes
James_V_of_Scotland	parent	Margaret_Tudor
Alfonso_VII_of_Le_n_and_Castile	child	Ferdinand_II_of_Le_n
Valdemar_I_of_Denmark	spouse	Sophia_of_Minsk
Louis_IX_of_France	gender	male
John_Count_of_Angoul_me	mother	Valentina_Visconti_Duchess_of_Orl_ans
Charles_VII_of_France	parent	Charles_VI_of_France
Charles_de_Lorraine_de_Vaud_mont	type	Person
Margaret_of_Flanders_Duchess_of_Brabant	gender	female
Emmanuel_Philibert_Duke_of_Savoy	mother	Beatrice_of_Portugal_Duchess_of_Savoy
Raymond_of_Burgundy	type	Person
Robert_II_of_France	spouse	Bertha_of_Burgundy
Beatriz_of_Portugal_Duchess_of_Viseu	hasSpouse	Yes
Francis_Count_of_Vend_me	gender	male
Eleanor_of_Provence	hasSpouse	Yes
Margaret_Douglas	type	Person
Philip_III_of_Navarre	child	Charles_II_of_Navarre
Marie_Jos_phine_of_Savoy	parent	Victor_Amadeus_III_of_Sardinia
Margaret_Boswell	hasSpouse	No
Louis_Philippe_II_Duke_of_Orl_ans	father	Louis_Philippe_I_Duke_of_Orl_ans
Taddea_Visconti	spouse	Stephen_III_Duke_of_Bavaria
James_II_of_Scotland	predecessor	James_I_of_Scotland
Theobald_II_Count_of_Champagne	type	Person
Letgarda_de_Rouergue	type	Person
Gertrude_of_Saxony	parent	Eilika_of_Schweinfurt
Maria_Amalia_of_Saxony	parent	Maria_Josepha_of_Austria
Marie_Louise_Duchess_of_Parma	type	Person
Marie_Countess_of_Ponthieu	parent	William_IV_Count_of_Ponthieu
Salomea_of_Berg	gender	female
Otto_IV_Count_of_Burgundy	type	Person
Eleanor_of_Aragon_Queen_of_Castile	type	Person
Peter_I_Count_of_Saint_Pol	hasSpouse	No
Afonso_I_of_Portugal	predecessor	Theresa_Countess_of_Portugal
Anne_of_Bohemia_and_Hungary	child	Catherine_of_Austria_Queen_of_Poland
Letizia_Bonaparte	type	Person
Theudoald	successor	Charles_Martel
Iziaslav_I_of_Kiev	predecessor	Yaroslav_the_Wise
Maria_Anna_of_Bavaria_born_1551	child	Margaret_of_Austria_Queen_of_Spain
Maria_Beatrice_of_Savoy	parent	Victor_Emmanuel_I_of_Sardinia
Bertha_of_Burgundy	gender	female
Richard_Duke_of_Burgundy	spouse	Adelaide_of_Auxerre_born_c._870
Rudolph_I_of_Burgundy	father	Conrad_II_Duke_of_Transjurane_Burgundy
Ebalus_Duke_of_Aquitaine	parent	Ranulf_II_of_Aquitaine
John_King_of_England	spouse	Isabella_Countess_of_Gloucester
Ernest_Duke_of_Austria	gender	male
Marie_Eleonore_of_Cleves	mother	Maria_of_Austria_Duchess_of_J_lich_Cleves_Berg
Louis_XII	spouse	Anne_of_Brittany
Louise_of_Savoy	spouse	Charles_Count_of_Angoul_me
Anne_of_Cyprus	parent	Janus_of_Cyprus
Frederick_I_Duke_of_Lorraine	spouse	Wierzchoslawa_Ludmilla_of_Greater_Poland
Gerard_Duke_of_Lorraine	parent	Gerard_de_Bouzonville
Francis_II_Holy_Roman_Emperor	child	Maria_Leopoldina_of_Austria
George_Louis_I_Count_of_Erbach_Erbach	type	Person
Philip_I_of_Castile	parent	Maximilian_I_Holy_Roman_Emperor
Gertrude_of_Saxony	spouse	Robert_I_Count_of_Flanders
Eleanor_of_Castile	spouse	Edward_I_of_England
Barbara_of_Cilli	type	Person
Afonso_V_of_Portugal	predecessor	Edward_King_of_Portugal
Isabella_of_Aragon_Queen_of_France	type	Person
Catherine_of_Cleves_1417_1479	type	Person
Fran_oise_d_Aubign__Marquise_de_Maintenon	gender	female
Fulk_IV_Count_of_Anjou	type	Person
Auguste_of_Bade_Baden	hasSpouse	Yes
Adelaide_of_Burgundy_Duchess_of_Brabant	parent	Yolande_of_Dreux_Duchess_of_Burgundy
Robert_II_of_France	child	Hedwig_of_France_Countess_of_Nevers
John_I_Duke_of_Brittany	predecessor	Alix_Duchess_of_Brittany
Beatrice_of_Bourbon_Queen_of_Bohemia	spouse	John_of_Bohemia
Alfonso_of_Molina	type	Person
Childebrand_I	type	Person
Edgar_King_of_Scotland	type	Person
Piero_the_Unfortunate	spouse	Alfonsina_Orsini
Victor_Amadeus_II_of_Sardinia	predecessor	Charles_Emmanuel_II_Duke_of_Savoy
Philip_II_Duke_of_Savoy	predecessor	Charles_II_Duke_of_Savoy
Henry_I_of_Navarre	mother	Margaret_of_Bourbon_Queen_of_Navarre
Charles_IV_of_Spain	predecessor	Charles_III_of_Spain
Anna_Eleonore_of_Hesse_Darmstadt	spouse	George_Duke_of_Brunswic_Calenberg
Nicholas_d_Oisy_Lord_of_Avesnes	hasSpouse	No
Charles_X	parent	Maria_Josepha_of_Saxony_Dauphine_of_France
Katherine_of_England	type	Person
Victor_Amadeus_II_of_Sardinia	predecessor	Charles_VI_Holy_Roman_Emperor
Louis_XI	spouse	Margaret_Stewart_Dauphine_of_France
Arnulf_II_Count_of_Flanders	parent	Baldwin_III_Count_of_Flanders
Eadgifu_of_Wessex	parent	Edward_the_Elder
Martin_of_Aragon	successor	Ferdinand_I_of_Aragon
Hugh_of_Tours	type	Person
Francis_I_Holy_Roman_Emperor	child	Archduchess_Maria_Elisabeth_of_Austria_born_1743
Berthold_Duke_of_Merania	parent	House_of_Wittelsbach
Louise_Marie_Ad_la_de_de_Bourbon_Duchess_of_Orl_ans	father	Louis_Jean_Marie_de_Bourbon_Duke_of_Penthi_vre
Matilda_of_France	mother	Gerberga_of_Saxony
Joan_Countess_of_Ponthieu	predecessor	Simon_Count_of_Ponthieu
John_VIII_Count_of_Vend_me	parent	Louis_Count_of_Vend_me
Sophia_of_Minsk	child	Richeza_of_Denmark
Robert_Stewart_Duke_of_Albany	type	Person
Eleanor_of_Portugal_Holy_Roman_Empress	parent	Edward_King_of_Portugal
Henry_the_Lion	successor	Bernhard_Count_of_Anhalt
Gisela_of_Burgundy_Marchioness_of_Montferrat	type	Person
