Lorenzo_de_Medici_Duke_of_Urbino	hasSpouse	Yes
Charles_III_Duke_of_Lorraine	spouse	Claude_of_France_1547_1575
Lambert_I_Count_of_Louvain	gender	male
Nuno__lvares_Pereira	type	Person
Galeazzo_Maria_Sforza	hasSpouse	Yes
Eleanor_of_Navarre	gender	male
John_II_Count_of_Holland	mother	Adelaide_of_Holland
Isabella_Clara_Eugenia	type	Person
James_I_of_Aragon	name	James_I
Engeltrude_de_F_zensac	name	Engeltrude_de_F_zensac
In_s_de_Castro	hasSpouse	No
Catalina_Micaela_of_Spain	type	Person
Eleanor_of_Alburquerque	child	John_II_of_Aragon
Charles_Ferdinand_Duke_of_Berry	mother	Louis_XVI
Henry_the_Lion	father	Henry_X_Duke_of_Bavaria
Gian_Gastone_de_Medici_Grand_Duke_of_Tuscany	type	Person
Richard_Count_of__tampes	mother	Joan_Holland_Duchess_of_Brittany
Constance_of_Arles	gender	female
Catherine_de_Medici	spouse	Henry_II_of_France
John_I_Count_of_Aumale	predecessor	Joan_Countess_of_Ponthieu
Matthias_II_Duke_of_Lorraine	parent	Frederick_II_Duke_of_Lorraine
John_I_of_Castile	parent	Henry_II_of_Castile
George_II_of_Great_Britain	parent	George_I_of_Great_Britain
Richardis	spouse	Charles_the_Fat
Blanche_of_Burgundy	parent	Otto_IV_Count_of_Burgundy
Fulk_King_of_Jerusalem	child	Matilda_of_Anjou
Otto_II_Duke_of_Bavaria	hasSpouse	Yes
Mary_of_Hungary_Queen_of_Naples	child	Robert_King_of_Naples
Louis_I_Duke_of_Orl_ans	mother	Joanna_of_Bourbon
Valdemar_I_of_Denmark	mother	Ingeborg_of_Kiev
Alice_of_Namur	spouse	Baldwin_IV_Count_of_Hainaut
Marie_of_France_Duchess_of_Bar	parent	John_II_of_France
Elizabeth_of_Austria_1436_1505	type	Person
Louise_Marie_Ad_la_de_de_Bourbon_Duchess_of_Orl_ans	mother	Maria_Teresa_Felicitas_d_Este
Ramon_Berenguer_III_Count_of_Barcelona	successor	Ramon_Berenguer_IV_Count_of_Barcelona
James_I_of_Scotland	child	Eleanor_of_Scotland
John_King_of_England	gender	male
Henry_I_Count_of_Berg	type	Person
Urraca_of_Le_n	type	Person
Francis_I_Holy_Roman_Emperor	child	Maria_Carolina_of_Austria
Marie_of_Brittany_Countess_of_Saint_Pol	gender	female
Odo_II_Count_of_Blois	mother	Bertha_of_Burgundy
Taddea_Visconti	hasSpouse	Yes
Simon_I_Duke_of_Lorraine	spouse	Adelaide_of_Leuven
Henry_VI_of_England	successor	Edward_IV_of_England
Louis_I_Duke_of_Orl_ans	child	John_Count_of_Angoul_me
Maria_Beatrice_d_Este_Duchess_of_Massa	father	Maria_Teresa_Cybo_Malaspina_Duchess_of_Massa
Catherine_of_Foix_Countess_of_Candale	type	Person
Anna_of_Holstei_Gottorp	name	Anna_of_Holstei_Gottorp
Vladimir_the_Great	father	Sviatoslav_I
Mary_Queen_of_Scots	gender	male
Philip_III_of_France	spouse	Isabella_of_Aragon_Queen_of_France
Sophia_Eleonore_of_Saxony	mother	Magdalene_Sibylle_of_Prussia
Eug_nie_de_Montijo	gender	female
Mar_a_Isabella_of_Spain	spouse	Francis_I_of_the_Two_Sicilies
Ladislaus_the_Posthumous	type	Person
Claude_of_France	father	Louis_XII
Louis_I_Duke_of_Bourbon	parent	Beatrice_of_Burgundy_Lady_of_Bourbon
Peter_of_Courtenay_Lord_of_Conches	type	Person
Alix_Duchess_of_Brittany	gender	female
Philip_of_France_Archdeacon_of_Paris	type	Person
Augustus_Duke_of_Saxe_Weissenfels	type	Person
Vladimir_the_Great	gender	male
Beatriz_of_Portugal_Duchess_of_Viseu	mother	Isabel_of_Barcelos
John_I_of_Castile	hasSpouse	Yes
Princess_Margaret_Yolande_of_Savoy	type	Person
Margaret_of_Savoy_Countess_of_Saint_Pol	father	Louis_Duke_of_Savoy
John_I_Duke_of_Brittany	gender	female
Margaret_Holland_Duchess_of_Clarence	parent	Alice_Holland_Countess_of_Kent
Margaret_of_Saxony_Duchess_of_Brunswic_L_neburg	hasSpouse	Yes
George_II_Landgrave_of_Hesse_Darmstadt	spouse	Sophia_Eleonore_of_Saxony
Emmanuel_Philibert_Duke_of_Savoy	spouse	Margaret_of_Valois_Duchess_of_Berry
Leopold_II_Holy_Roman_Emperor	child	Archduke_Rudolf_of_Austria
Mar_a_Isabella_of_Spain	gender	female
Beatriz_of_Portugal_Duchess_of_Viseu	child	Isabel_of_Viseu
Louis_X_of_France	spouse	Clementia_of_Hungary
Maria_Anna_of_Bavaria_born_1551	gender	female
Maximilian_I_Holy_Roman_Emperor	spouse	Mary_of_Burgundy
Philip_III_of_Spain	type	Person
John_I_of_Portugal	type	Person
Pepin_of_Herstal	spouse	Plectrude
Louis_Antoine_Duke_of_Angoul_me	mother	Marie_Antoinette
Maria_of_Austria_Duchess_of_J_lich_Cleves_Berg	mother	Anne_of_Bohemia_and_Hungary
Princess_Elisabeth_Albertine_of_Saxe_Hildburghausen	marriedTo	Duke_Charles_Louis_Frederick_of_Mecklenburg
Henry_the_Fowler	child	Bruno_the_Great
Matthew_Stewart_2nd_Earl_of_Lennox	parent	Margaret_Boswell
Ferdinand_I_Holy_Roman_Emperor	father	Philip_I_of_Castile
Francis_I_of_France	father	Charles_Count_of_Angoul_me
Charles_Emmanuel_I_Duke_of_Savoy	child	Thomas_Francis_Prince_of_Carignano
Henry_IV_of_Castile	type	Person
Joan_the_Lame	parent	Agnes_of_France_Duchess_of_Burgundy
Maredudd_ap_Tudur	parent	Marged_ferch_Tomos
Louis_IV_Holy_Roman_Emperor	predecessor	Rudolf_I_Duke_of_Bavaria
Isabella_Duchess_of_Lorraine	hasSpouse	Yes
Hugh_V_Duke_of_Burgundy	type	Person
Edmund_of_Scotland	type	Person
Beatrice_of_Castile_1242_1303	hasSpouse	Yes
Elizabeth_of_Austria_1436_1505	spouse	Casimir_IV_Jagiellon
Maria_of_Austria_Holy_Roman_Empress	child	Anna_of_Austria_Queen_of_Spain
Edward_I_of_England	gender	male
Ferdinand_I_of_Aragon	child	Eleanor_of_Aragon_Queen_of_Portugal
Margaret_of_Bavaria	gender	female
Ecgberht_King_of_Wessex	hasSpouse	Yes
John_I_of_Portugal	mother	Teresa_Louren_o
Joan_Stewart_Countess_of_Morton	type	Person
Margaret_Douglas	type	Person
James_I_Count_of_La_Marche	hasSpouse	No
Benedicta_Henrietta_of_the_Palatinate	hasSpouse	Yes
Mary_of_Burgundy	spouse	Maximilian_I_Holy_Roman_Emperor
Adolph_I_Duke_of_Cleves	spouse	Mary_of_Burgundy_Duchess_of_Cleves
William_the_Younger_Duke_of_Brunswic_L_neburg	predecessor	Ernest_I_Duke_of_Brunswic_L_neburg
Willa_of_Tuscany	type	Person
Robert_II_Count_of_Hesbaye	type	Person
Anne_of_Brittany	mother	Margaret_of_Foix
Manuel_I_of_Portugal	spouse	Eleanor_of_Austria
Yolande_of_Aragon	parent	John_I_of_Aragon
Richende_De_Bourges	type	Person
Anastasia_of_Kiev	type	Person
Adalbert_of_Italy	hasSpouse	No
Jacquetta_of_Luxembourg	child	Anthony_Woodville_2nd_Earl_Rivers
William_X_Duke_of_Aquitaine	successor	Eleanor_of_Aquitaine
Richard_II_of_England	type	Person
Eleanor_of_England_Queen_of_Castile	child	Blanche_of_Castile
Jacques_de_Foix_Count_of_Montfort	type	Person
Odo_of_France	spouse	Th_odrate_of_Troyes
Peter_I_Duke_of_Bourbon	parent	Mary_of_Avesnes
Margaret_of_Provence	child	Blanche_of_France_Infanta_of_Castile
Claude_of_France_1547_1575	hasSpouse	Yes
Philip_V_of_France	predecessor	John_I_of_France
Piero_the_Unfortunate	mother	Clarice_Orsini
Charles_Ferdinand_Duke_of_Berry	spouse	Marie_Caroline_of_Bourbo_Two_Sicilies_Duchess_of_Berry
Adelaide_of_Paris	spouse	Louis_the_Stammerer
Frederick_III_Duke_of_Lorraine	father	Matthias_II_Duke_of_Lorraine
Charles_II_Archduke_of_Austria	type	Person
Marie_of_Luxembourg_Countess_of_Vend_me	parent	Margaret_of_Savoy_Countess_of_Saint_Pol
Mary_Queen_of_Scots	father	James_V_of_Scotland
Gertrude_of_Hohenberg	spouse	Rudolf_I_of_Germany
Robert_I_of_France	spouse	Beatrice_of_Vermandois
Ingerman_Count_of_Hesbaye	hasSpouse	Yes
Louis_V_Duke_of_Bavaria	type	Person
Louis_XIII	predecessor	Henry_IV_of_France
Archbishop_of_Canterbury	type	Person
Albert_I_of_Germany	gender	male
Marie_of_Cleves_Duchess_of_Orl_ans	father	Adolph_I_Duke_of_Cleves
Charles_Duke_of_Vend_me	name	Charles
Afonso_III_of_Portugal	child	Sancha_of_Portugal_born_1264
Christine_of_Saxony	child	Anna_of_Hesse
Louise_Diane_Princess_of_Conti	type	Person
John_I_Count_of_La_Marche	hasSpouse	No
Philip_II_of_Spain	mother	Isabella_of_Portugal_Queen_of_Castile
Bertha_of_Holland	gender	female
Richard_III_of_England	successor	Henry_VII_of_England
Adolphus_Frederick_IV_Duke_of_Mecklenburg_Strelitz	type	Person
Maria_Manuela_Princess_of_Portugal	spouse	Philip_II_of_Spain
Louise_Marie_Ad_la_de_de_Bourbon_Duchess_of_Orl_ans	father	Louis_Jean_Marie_de_Bourbon_Duke_of_Penthi_vre
Eleanor_of_Aragon_Queen_of_Portugal	child	Eleanor_of_Portugal_Holy_Roman_Empress
Fulk_King_of_Jerusalem	child	Elias_II_Count_of_Maine
Charles_the_Bold	successor	Mary_of_Burgundy
Francis_V_Duke_of_Modena	parent	Francis_IV_Duke_of_Modena
Helena_of_Denmark	spouse	William_of_Winchester_Lord_of_Lunenburg
Louise_of_Savoy	father	Philip_II_Duke_of_Savoy
Nicolas_Duke_of_Merc_ur	father	Antoine_Duke_of_Lorraine
Alderano_I_Cybo_Malaspina	hasSpouse	Yes
Francis_Hyacinth_Duke_of_Savoy	successor	Charles_Emmanuel_II_Duke_of_Savoy
Marie_de_Medici	spouse	Henry_IV_of_France
Hortense_de_Beauharnais	parent	Napoleon
Fulk_III_Count_of_Anjou	hasSpouse	Yes
James_I_Count_of_La_Marche	parent	Louis_I_Duke_of_Bourbon
Louis_XV	father	Louis_Duke_of_Burgundy
Matilda_of_Bavaria_Margravine_of_Meissen	parent	Beatrice_of_Silesia
Constance_of_Castile	parent	Berengaria_of_Barcelona
Princess_Augusta_of_Saxe_Gotha	spouse	Frederick_Prince_of_Wales
Isabella_de_Medici	type	Person
William_III_of_M_con	type	Person
John_I_of_Castile	predecessor	Henry_II_of_Castile
Louis_Philippe_I	type	Person
Simon_I_Duke_of_Lorraine	hasSpouse	Yes
John_of_Bohemia	child	Bonne_of_Luxembourg
Eleanor_of_England_Queen_of_Castile	hasSpouse	Yes
Sancho_IV_of_Castile	child	Peter_of_Castile_Lord_of_Cameros
Beatrice_of_Portugal_Duchess_of_Savoy	spouse	Charles_III_Duke_of_Savoy
Viridis_Visconti	type	Person
John_II_of_Aragon	predecessor	Alfonso_V_of_Aragon
Charles_IV_of_France	hasSpouse	Yes
Dirk_I_Count_of_Holland	parent	Gerolf_of_Holland
Margaret_Stewart_Lady_Gordon	type	Person
John_de_Beaumont_2nd_Baron_Beaumont	spouse	Eleanor_of_Lancaster
Margaret_of_Austria_Queen_of_Spain	father	Charles_II_Archduke_of_Austria
Adelaide_of_Leuven	spouse	Simon_I_Duke_of_Lorraine
Charlotte_of_Mecklenburg_Strelitz	child	George_IV
Frederick_II_Duke_of_Lorraine	parent	Frederick_I_Duke_of_Lorraine
Antonia_of_Lorraine	type	Person
Henry_I_Count_of_Champagne	hasSpouse	Yes
Alfred_the_Great	successor	Edward_the_Elder
Princess_Elisabeth_Albertine_of_Saxe_Hildburghausen	father	Ernest_Frederick_I_Duke_of_Saxe_Hildburghausen
Maria_Anna_of_Bavaria_born_1551	child	Archduchess_Maria_Maddalena_of_Austria
Barbara_of_Cilli	father	Hermann_II_Count_of_Celje
Ernest_Frederick_I_Duke_of_Saxe_Hildburghausen	type	Person
Otto_Duke_of_Austria	type	Person
Ferdinand_II_of_Aragon	type	Person
Henry_III_of_France	predecessor	Charles_IX_of_France
Henry_IV_of_France	father	William_Duke_of_J_lich_Cleves_Berg
Francis_I_of_the_Two_Sicilies	hasSpouse	Yes
Napoleon	type	Person
Bertha_of_Burgundy	mother	Matilda_of_France
George_Gordon_4th_Earl_of_Huntly	parent	John_Gordon_Lord_Gordon
Frederick_Prince_of_Wales	child	George_III
Louis_the_Pious	hasSpouse	Yes
Anne_Marie_d_Orl_ans	child	Marie_Ad_la_de_of_Savoy
Afonso_III_of_Portugal	mother	Urraca_of_Castile_Queen_of_Portugal
Isambart	hasSpouse	Yes
Osburh	spouse	_thelwulf_King_of_Wessex
_thelwulf_King_of_Wessex	parent	Ecgberht_King_of_Wessex
Arthur_Prince_of_Wales	type	Person
Charles_Duke_of_Orl_ans	spouse	Bonne_of_Armagnac
Mar_a_Manuela_Kirkpatrick_de_Grevign_e	hasSpouse	No
Landgravine_Elisabeth_Amalie_of_Hesse_Darmstadt	child	Countess_Palatine_Hedwig_Elisabeth_of_Neuburg
Henry_II_of_France	mother	Claude_of_France
Eleanor_of_Navarre	type	Person
Mar_a_de_Molina	type	Person
Hiltrud	type	Person
Henry_VII_of_England	parent	Edmund_Tudor_1st_Earl_of_Richmond
Rudolf_I_of_Germany	child	Hedwig_of_Habsburg
Thomas_Holland_2nd_Earl_of_Kent	type	Person
Adelaide_of_Tours	child	Hugh_the_Abbot
Ferdinand_I_of_the_Two_Sicilies	child	Princess_Maria_Isabella_of_Naples_and_Sicily
Philippe_I_Duke_of_Orl_ans	father	Louis_XIII
Ecgberht_King_of_Wessex	father	Ealhmund_of_Kent
Beatrice_of_Brandenburg	hasSpouse	Yes
Berengar_II_of_Italy	successor	Otto_I_Holy_Roman_Emperor
Charles_VII_of_France	hasSpouse	Yes
George_III	child	Prince_Octavius_of_Great_Britain
Emma_of_France	type	Person
Radbot_of_Klettgau	parent	Lanzelin_Count_of_Habsburg
Conrad_I_Count_of_Auxerre	type	Person
Saint_Margaret_of_Scotland	father	Edward_the_Exile
Eadhild	type	Person
Frederick_I_Duke_of_Lorraine	type	Person
Theobald_I_of_Navarre	hasSpouse	No
Edward_Count_Palatine_of_Simmern	spouse	Anne_Gonzaga
Emmanuel_Philibert_Duke_of_Savoy	parent	Charles_III_Duke_of_Savoy
Charles_the_Bald	type	Person
Alix_Duchess_of_Brittany	gender	male
Alfonso_XI_of_Castile	parent	Ferdinand_IV_of_Castile
Anna_of_Austria_Queen_of_Spain	hasSpouse	Yes
Marie_Eleonore_of_Cleves	mother	Maria_of_Austria_Duchess_of_J_lich_Cleves_Berg
Louis_Dauphin_of_France_son_of_Louis_XIV	hasSpouse	Yes
Antoinette_of_Bourbon	hasSpouse	Yes
Welf_I_Duke_of_Bavaria	parent	Albert_Azzo_II_Margrave_of_Milan
Henry_IV_of_France	hasSpouse	Yes
Ferdinand_Karl_Archduke_of_Austria_Este	child	Archduke_Ferdinand_Karl_Joseph_of_Austria_Este
Joan_I_of_Navarre	father	Edmund_Crouchback
Charles_the_Simple	father	Louis_the_Stammerer
Beatrice_of_Bourbon_Queen_of_Bohemia	spouse	John_of_Bohemia
Charles_IV_Holy_Roman_Emperor	type	Person
Charlemagne	name	Charlemagne
Charles_V_Holy_Roman_Emperor	predecessor	Philip_I_of_Castile
Louis_Bonaparte	parent	Letizia_Bonaparte
Margaret_I_Countess_of_Burgundy	type	Person
George_II_of_Great_Britain	child	Prince_George_William_of_Great_Britain
Sophia_of_Minsk	name	Sophia_of_Minsk
Taddea_Visconti	parent	Bernab__Visconti
Countess_Palatine_Dorothea_Sophie_of_Neuburg	father	Philip_William_Elector_Palatine
William_X_Duke_of_Aquitaine	gender	female
Victor_Emmanuel_I_of_Sardinia	hasSpouse	Yes
Magdalene_Sibylle_of_Prussia	mother	Marie_Eleonore_of_Cleves
Louis_the_Stammerer	predecessor	Charles_the_Bald
Alfred_the_Great	child	_thelweard_son_of_Alfred
Margaret_of_Anjou	hasSpouse	Yes
Philip_III_of_Navarre	gender	female
Wilhelmine_Amalie_of_Brunswick	parent	Benedicta_Henrietta_of_the_Palatinate
Edward_King_of_Portugal	child	Eleanor_of_Portugal_Holy_Roman_Empress
Bertha_of_Swabia	spouse	Rudolph_II_of_Burgundy
Robert_II_of_Scotland	child	Robert_Stewart_Duke_of_Albany
Judith_of_Habsburg	mother	Isabella_of_Burgundy_Queen_of_Germany
Matthew_Stewart_2nd_Earl_of_Lennox	gender	male
Maria_Theresa_of_Spain	parent	Elisabeth_of_France_1602_1644
Maximilian_Sforza	predecessor	Louis_XII
Maria_Carolina_of_Austria	child	Prince_Alberto_of_Naples_and_Sicily
Robert_Duke_of_Bar	type	Person
Maria_of_Aragon_Queen_of_Portugal	mother	Isabella_I_of_Castile
Elisabeth_of_Sicily_Duchess_of_Bavaria	spouse	Stephen_II_Duke_of_Bavaria
Louis_Dauphin_of_France_son_of_Louis_XV	child	Louis_XVI
Philippe_II_Duke_of_Orl_ans	gender	male
Lorenzo_de_Medici	parent	Piero_di_Cosimo_de_Medici
Henry_II_of_Castile	successor	John_I_of_Castile
K_ten	hasSpouse	Yes
Louis_Antoine_Duke_of_Angoul_me	parent	Maria_Theresa_of_Savoy
Marie_of_France_Countess_of_Champagne	spouse	Henry_I_Count_of_Champagne
Philip_Duke_of_Parma	hasSpouse	Yes
Eleanor_of_Castile	father	Ferdinand_III_of_Castile
Reginar_III_Count_of_Hainaut	mother	Adelaide_of_Burgundy_born_c._896
Joanna_of_Castile	predecessor	Ferdinand_II_of_Aragon
Tudur_ap_Goronwy	type	Person
Maria_Amalia_of_Naples_and_Sicily	child	Princess_Cl_mentine_of_Orl_ans
Prince_Benedetto_Duke_of_Chablais	type	Person
Agnes_of_Merania	mother	Agnes_of_Rochlitz
Louis_IX_of_France	child	Louis_of_France_1244_1260
Judith_of_Flanders_died_1095	hasSpouse	Yes
Charles_Count_of_Valois	gender	male
James_of_Castile_Lord_of_Cameros	type	Person
John_IV_of_Portugal	predecessor	Philip_IV_of_Spain
Adelaide_of_Tours	type	Person
Floris_I_Count_of_Holland	father	Dirk_III_Count_of_Holland
Peter_of_Courtenay_Lord_of_Conches	parent	Robert_of_Courtenay_Lord_of_Champignelles
Philip_II_Duke_of_Savoy	parent	Louis_Duke_of_Savoy
Geoffrey_Plantagenet_Count_of_Anjou	child	William_FitzEmpress
Blanche_of_Artois	parent	Robert_I_Count_of_Artois
Matilda_of_Brabant_Countess_of_Artois	hasSpouse	Yes
Ferdinand_II_of_Aragon	father	John_II_of_Aragon
Yaroslav_the_Wise	successor	Iziaslav_I_of_Kiev
Henry_I_of_Castile	predecessor	Alfonso_VIII_of_Castile
Anne_of_Brittany	type	Person
Philip_of_France_1116_1131	gender	male
Maria_Anna_of_Savoy	type	Person
Maria_Beatrice_d_Este_Duchess_of_Massa	gender	female
Joan_of_Navarre_Queen_of_England	spouse	Henry_IV_of_England
Agust_n_Mar_a_Mu_oz_y_Borb_n_1st_Duke_of_Taranc_n	type	Person
John_I_of_Portugal	child	John_Constable_of_Portugal
Frederick_I_Count_of_Vaud_mont	hasSpouse	Yes
Maximilian_I_Holy_Roman_Emperor	type	Person
Margaret_Countess_of_Anjou	gender	female
Jeanne_d_Albret	predecessor	Henry_II_of_Navarre
Urraca_of_Castile_Queen_of_Portugal	spouse	Afonso_II_of_Portugal
Louis_Count_of_Vend_me	parent	John_I_Count_of_La_Marche
Constant_d_Aubign_	hasSpouse	Yes
Archduke_Anton_Victor_of_Austria	type	Person
Eleanor_of_Provence	father	Ramon_Berenguer_IV_Count_of_Provence
Denis_of_Portugal	mother	Beatrice_of_Castile_1242_1303
Margaret_of_Valois_Duchess_of_Berry	hasSpouse	Yes
Adelaide_of_Tours	child	Robert_I_of_France
Eleanor_of_Aragon_Queen_of_Castile	spouse	John_I_of_Castile
Robert_II_Duke_of_Burgundy	parent	Yolande_of_Dreux_Duchess_of_Burgundy
Margaret_of_Geneva	gender	female
Albert_III_Count_of_Habsburg	type	Person
Philip_William_Elector_Palatine	type	Person
Fran_oise_Marie_de_Bourbon	child	Louise__lisabeth_d_Orl_ans
Louis_Duke_of_Savoy	mother	Mary_of_Burgundy_Duchess_of_Savoy
Gerloc	name	Gerloc
Galeazzo_Maria_Sforza	predecessor	Francesco_I_Sforza
Elizabeth_Woodville	child	Catherine_of_York
Hugh_V_Duke_of_Burgundy	successor	Odo_IV_Duke_of_Burgundy
Francis_II_of_France	spouse	Mary_Queen_of_Scots
Simon_I_Duke_of_Lorraine	successor	Matthias_I_Duke_of_Lorraine
Brun_I_Count_of_Brunswick	type	Person
John_King_of_England	child	Henry_III_of_England
Margaret_of_Foix	child	Francis_II_Duke_of_Brittany
Emma_of_Italy	gender	female
Ermengarde_of_Anjou_Duchess_of_Burgundy	parent	Fulk_III_Count_of_Anjou
Elisabeth_of_Austria_Queen_of_France	gender	female
Henry_VII_of_England	mother	Lady_Margaret_Beaufort
Olga_of_Kiev	spouse	Igor_of_Kiev
Adelaide_of_Auxerre_born_c._870	parent	Conrad_II_Duke_of_Transjurane_Burgundy
Ferdinand_II_of_Aragon	mother	Blanche_I_of_Navarre
Charles_IX_of_France	successor	Henry_III_of_France
Edward_the_Elder	child	_thelstan
John_of_Montfort	predecessor	John_III_Duke_of_Brittany
Louis_Duke_of_Savoy	father	Amadeus_VIII_Duke_of_Savoy
Charles_Martel	child	Carloman_mayor_of_the_palace
Lorenzo_the_Elder	hasSpouse	Yes
Roman_Catholic_Archdiocese_of_Cambrai	type	Person
Rurik	name	Rurik
Eleanor_of_Aquitaine	child	Marie_of_France_Countess_of_Champagne
Fulk_King_of_Jerusalem	gender	male
Charles_V_Holy_Roman_Emperor	mother	Joanna_of_Castile
Maximilian_II_Holy_Roman_Emperor	child	Rudolf_II_Holy_Roman_Emperor
Ferdinand_I_of_the_Two_Sicilies	name	Ferdinand_I
Floris_I_Count_of_Holland	hasSpouse	No
Ingeborg_of_Denmark_Queen_of_France	father	Valdemar_I_of_Denmark
Catherine_de_Medici	child	Elisabeth_of_Valois
Charles_VII_of_France	child	Marie_de_Valois
Conrad_II_Duke_of_Transjurane_Burgundy	type	Person
Eleanor_of_Aquitaine	spouse	Henry_II_of_England
Henry_X_Duke_of_Bavaria	type	Person
Margaret_of_Foix	mother	Eleanor_of_Navarre
Francis_I_of_France	child	Madeleine_of_Valois
Peter_II_of_Aragon	gender	male
Robert_II_Duke_of_Burgundy	child	Louis_of_Burgundy
Jeanne_d_Albret	predecessor	Antoine_of_Navarre
Louis_the_German	parent	Louis_the_Pious
Alfonso_IX_of_Le_n	father	Ferdinand_II_of_Le_n
Anna_Maria_of_Mecklenburg_Schwerin	child	Heinrich_of_Saxe_Weissenfels_Count_of_Barby
Yolanda_Latin_Empress	predecessor	Peter_II_of_Courtenay
Prince_Philippe_Count_of_Paris	child	Prince_Ferdinand_Duke_of_Montpensier
Louis_I_Duke_of_Bavaria	mother	Agnes_of_Loon
Margaret_of_Burgundy_Queen_of_France	father	Robert_II_Duke_of_Burgundy
Matthias_I_Duke_of_Lorraine	parent	Simon_I_Duke_of_Lorraine
Fulk_King_of_Jerusalem	hasSpouse	Yes
Maria_of_Aragon_Queen_of_Portugal	child	Cardinal_Infante_Afonso_of_Portugal
William_VIII_Duke_of_Aquitaine	spouse	Hildegarde_of_Burgundy
Alfonso_VIII_of_Castile	parent	Blanca_of_Navarre_Queen_of_Castile
Henry_V_of_England	mother	Mary_de_Bohun
Charlotte_of_Bourbon_Queen_of_Cyprus	child	John_II_of_Cyprus
Princess_Augusta_of_Saxe_Gotha	child	Princess_Elizabeth_of_Great_Britain
Louis_XV	type	Person
Joanna_of_Bourbon	type	Person
Archduchess_Marie_Anne_of_Austria	type	Person
Frederuna	type	Person
Hemma	child	Louis_the_Younger
Henrietta_of_England	child	Marie_Louise_d_Orl_ans
William_of_Winchester_Lord_of_Lunenburg	hasSpouse	Yes
Louis_IX_of_France	child	Peter_I_Count_of_Alen_on
Frederick_I_Count_of_Vaud_mont	spouse	Margaret_of_Joinville
James_I_of_Aragon	child	Isabella_of_Aragon_Queen_of_France
Napol_on_Charles_Bonaparte	type	Person
James_I_Count_of_La_Marche	mother	Mary_of_Avesnes
Princess_Anne_Charlotte_of_Lorraine	type	Person
Marie_of_Bade_Sponheim	type	Person
Baldwin_II_Margrave_of_Flanders	spouse	_lfthryth_Countess_of_Flanders
Henriette_of_France_1727_1752	type	Person
John_VIII_Count_of_Vend_me	type	Person
Henry_X_Duke_of_Bavaria	parent	Henry_IX_Duke_of_Bavaria
Joan_I_of_Navarre	predecessor	Henry_I_of_Navarre
Robert_the_Strong	gender	male
Theobald_II_Duke_of_Lorraine	gender	male
Louise_of_Savoy	hasSpouse	Yes
Rudolph_I_of_Burgundy	parent	Waldrada_of_Worms
Mary_of_Burgundy_Duchess_of_Cleves	child	Margaret_of_Cleves_Duchess_of_Bavaria_Munich
Alfonso_X_of_Castile	child	James_of_Castile_Lord_of_Cameros
Francis_Duke_of_Anjou	parent	Henry_II_of_France
Willa_of_Tuscany	hasSpouse	Yes
Ren__of_Anjou	mother	Yolande_of_Aragon
Duke_Charles_Louis_Frederick_of_Mecklenburg	father	Adolphus_Frederick_II_Duke_of_Mecklenburg_Strelitz
Henry_V_of_England	parent	Joan_of_Navarre_Queen_of_England
Louis_XII	child	Ren_e_of_France
Louis_XVIII	predecessor	Napoleon
Afonso_II_of_Portugal	child	Fernando_Lord_of_Serpa
Maria_Theresa_of_Naples_and_Sicily	mother	Maria_Carolina_of_Austria
Hedwig_of_Bavaria	gender	female
Maria_Josepha_of_Saxony_Dauphine_of_France	child	Louis_XVI
Charles_II_of_Naples	hasSpouse	Yes
Louis_I_of_Anjou	parent	Bonne_of_Luxembourg
Joan_of_Navarre_Queen_of_England	spouse	John_IV_Duke_of_Brittany
Matthew_Stewart_4th_Earl_of_Lennox	spouse	Margaret_Douglas
Louis_Dauphin_of_France_son_of_Louis_XV	child	_lisabeth_of_France
Adelaide_of_Maurienne	child	Peter_I_of_Courtenay
Joanna_of_Castile	father	Ferdinand_II_of_Aragon
Bernard_I_Duke_of_Brunswic_L_neburg	hasSpouse	No
Charles_VI_Holy_Roman_Emperor	successor	Maria_Theresa
Ramon_Berenguer_IV_Count_of_Barcelona	successor	Alfonso_II_of_Aragon
Rothilde	type	Person
Yaroslav_the_Wise	hasSpouse	Yes
Antoine_Duke_of_Montpensier	predecessor	Antoine_Philippe_Duke_of_Montpensier
Alys_of_France_Countess_of_Vexin	parent	Adela_of_Champagne
Alice_Holland_Countess_of_Kent	parent	Eleanor_of_Lancaster
Maria_Josepha_of_Austria	child	Maria_Anna_Sophia_of_Saxony
Charles_VII_of_France	child	Radegonde_of_Valois
Stephen_II_Duke_of_Bavaria	type	Person
Francis_Duke_of_Anjou	hasSpouse	Yes
Schwerin	type	Person
Rudolph_I_of_Burgundy	hasSpouse	Yes
Louis_XII	mother	Isabella_of_Valois
Anne_Gonzaga	parent	Charles_I_Gonzaga_Duke_of_Mantua
Blanche_of_Navarre_Duchess_of_Brittany	type	Person
Louis_Philippe_I_Duke_of_Orl_ans	gender	male
Matilda_of_Habsburg	type	Person
Peter_I_Duke_of_Brittany	type	Person
Maria_Amalia_of_Naples_and_Sicily	type	Person
Caroline_Bonaparte	type	Person
Philip_II_of_France	spouse	Ingeborg_of_Denmark_Queen_of_France
Maria_Theresa_of_Austria_Este_Queen_of_Sardinia	parent	Maria_Beatrice_d_Este_Duchess_of_Massa
Peter_III_of_Aragon	parent	James_I_of_Aragon
Princess_Marie_Isabelle_of_Orl_ans	type	Person
Blanche_of_Anjou	type	Person
Robert_II_of_France	gender	male
Frederick_I_Duke_of_Lorraine	spouse	Wierzchoslawa_Ludmilla_of_Greater_Poland
Adelaide_of_Aquitaine	father	William_III_Duke_of_Aquitaine
Amaury_I_de_Montfort	type	Person
Marie_Eleonore_of_Cleves	spouse	Albert_Frederick_Duke_of_Prussia
Philippa_of_Guelders	spouse	Ren__II_Duke_of_Lorraine
Gian_Galeazzo_Sforza	type	Person
John_Stewart_3rd_Earl_of_Lennox	type	Person
Adelaide_of_Aquitaine	mother	Gerloc
William_Duke_of_J_lich_Cleves_Berg	type	Person
Charles_Emmanuel_I_Duke_of_Savoy	father	Emmanuel_Philibert_Duke_of_Savoy
Maria_Theresa_of_Naples_and_Sicily	father	Ferdinand_I_of_the_Two_Sicilies
Simon_I_Duke_of_Lorraine	predecessor	Theodoric_II_Duke_of_Lorraine
Robert_II_Duke_of_Burgundy	father	Hugh_IV_Duke_of_Burgundy
George_Gordon_4th_Earl_of_Huntly	hasSpouse	No
Henry_V_of_England	spouse	Catherine_of_Valois
James_I_Count_of_La_Marche	father	Louis_I_Duke_of_Bourbon
Fulk_King_of_Jerusalem	child	Sibylla_of_Anjou
John_of_Gaunt	child	Henry_IV_of_England
Louis_I_of_Spain	type	Person
Denis_of_Portugal	mother	Matilda_II_Countess_of_Boulogne
Constance_of_Arles	child	Hugh_Magnus
Louis_Duke_of_Burgundy	mother	Marie__milie_de_Joly_de_Choin
Henry_I_of_England	spouse	Matilda_of_Scotland
William_the_Younger_Duke_of_Brunswic_L_neburg	child	Sophie_of_Brunswic_L_neburg
Gerberga_of_Lower_Lorraine	hasSpouse	Yes
Marie_of_Savoy_Countess_of_Saint_Pol	type	Person
Isabella_of_Hainault	parent	Margaret_I_Countess_of_Flanders
Marie_of_Brabant_Queen_of_France	parent	Henry_III_Duke_of_Brabant
Robert_the_Strong	type	Person
Mary_of_Hungary_governor_of_the_Netherlands	type	Person
Elizabeth_of_York	child	Elizabeth_Tudor_1492_1495
Humbert_II_Count_of_Savoy	parent	Joan_of_Geneva
Joan_II_Countess_of_Burgundy	hasSpouse	Yes
Robert_the_Strong	parent	Waldrada_of_Worms
Isabella_of_Aragon_Queen_of_France	mother	Teresa_Gil_de_Vidaure
Blanche_of_Navarre_Queen_of_France	parent	Joan_II_of_Navarre
Fulk_IV_Count_of_Anjou	child	Geoffrey_IV_Count_of_Anjou
John_I_of_France	type	Person
Francis_I_Holy_Roman_Emperor	child	Maria_Christina_Duchess_of_Teschen
Pedro_Fern_ndez_de_Castro	hasSpouse	Yes
Violant_of_Bar	gender	female
Rudolph_II_of_Burgundy	type	Person
Letgarda_de_Rouergue	hasSpouse	No
Hugh_IV_Duke_of_Burgundy	child	John_of_Burgundy_1231_68
Magdalene_Sibylle_of_Prussia	spouse	John_George_I_Elector_of_Saxony
Fran_oise_d_Aubign__Marquise_de_Maintenon	parent	Constant_d_Aubign_
_lffl_d_wife_of_Edward_the_Elder	hasSpouse	Yes
Elisabeth_of_Cleves	spouse	Stephen_III_Duke_of_Bavaria
Eleanor_of_England_Queen_of_Castile	mother	Eleanor_of_Aquitaine
Maria_Beatrice_d_Este_Duchess_of_Massa	child	Francis_IV_Duke_of_Modena
Stephen_II_Duke_of_Bavaria	mother	Beatrice_of_Silesia
Vladimir_the_Great	child	Yaroslav_the_Wise
Louis_XVII	father	Louis_XVI
Prince_Charles_Alexander_of_Lorraine	type	Person
Fran_oise_Marie_de_Bourbon	child	Philippine__lisabeth_d_Orl_ans
Alice_of_Vergy	type	Person
Charles_X	child	Sophie_of_France_1776_1783
Reginar_III_Count_of_Hainaut	hasSpouse	No
Robert_II_Count_of_Artois	gender	male
Maria_Josepha_of_Austria	child	Charles_of_Saxony_Duke_of_Courland
Marie_Louise_d_Orl_ans	type	Person
Philippe_II_Duke_of_Orl_ans	mother	Henrietta_of_England
Alexander_Stewart_of_Darnley_died_1404	hasSpouse	No
Ferdinand_IV_of_Castile	parent	Sancho_IV_of_Castile
Valdemar_I_of_Denmark	child	Ingeborg_of_Denmark_Queen_of_France
Henry_IV_of_England	successor	Henry_V_of_England
Hugh_Magnus	successor	Henry_I_of_France
Ferdinand_II_of_Le_n	spouse	Urraca_L_pez_de_Haro
Marie_of_Brabant_Queen_of_France	hasSpouse	Yes
Ramon_Berenguer_I_Count_of_Barcelona	spouse	Almodis_de_la_Marche
Janus_of_Cyprus	spouse	Charlotte_of_Bourbon_Queen_of_Cyprus
Beatrice_of_Savoy_Lady_of_Villena	hasSpouse	Yes
Frederick_II_Duke_of_Brunswic_L_neburg	type	Person
Philip_III_of_Navarre	type	Person
Marie_of_Anjou	mother	John_I_of_Aragon
Louis_XV	child	Louise__lisabeth_of_France
Maria_Salviati	spouse	Giovanni_delle_Bande_Nere
Charles_II_of_Spain	parent	Philip_IV_of_Spain
Clarice_Orsini	spouse	Lorenzo_de_Medici
Otto_IV_Count_of_Burgundy	successor	Joan_II_Countess_of_Burgundy
Margaret_of_Brittany	type	Person
Lothair_of_France	gender	male
Saint_Casimir	type	Person
Henry_I_Duke_of_Burgundy	type	Person
Maria_Theresa_of_Austria_Este_Queen_of_Sardinia	child	Maria_Teresa_of_Savoy_1803_1879
Mahaut_Countess_of_Artois	gender	male
Charles_VII_of_France	parent	Isabeau_of_Bavaria
Matilda_of_Carinthia	hasSpouse	No
Edward_I_of_England	type	Person
Juana_Manuel	hasSpouse	Yes
Maria_Teresa_Cybo_Malaspina_Duchess_of_Massa	predecessor	Alderano_I_Cybo_Malaspina
Sviatoslav_I	parent	Igor_of_Kiev
Hugh_the_Great	hasSpouse	Yes
Walter_Stewart_3rd_High_Steward_of_Scotland	successor	Alexander_Stewart_4th_High_Steward_of_Scotland
Alfonso_Fern_ndez_el_Ni_o	type	Person
Rudolf_I_of_Germany	child	Matilda_of_Habsburg
Marie_of_Brittany_Countess_of_Saint_Pol	type	Person
Isabella_of_Aragon_Queen_of_France	mother	Violant_of_Hungary
Philip_IV_of_Spain	father	Philip_III_of_Spain
Christine_of_Saxony	hasSpouse	Yes
Count_of_Montijo	type	Person
Rudolph_II_of_Burgundy	predecessor	Rudolph_I_of_Burgundy
John_II_of_Aragon	gender	male
Petronilla_of_Aragon	successor	Alfonso_II_of_Aragon
Carloman_II	parent	Adelaide_of_Paris
Charles_Duke_of_Vend_me	mother	Marie_of_Luxembourg_Countess_of_Vend_me
James_V_of_Scotland	hasSpouse	Yes
Yolanda_Latin_Empress	child	Margaret_Marchioness_of_Namur
Mar_a_Amparo_Mu_oz_y_Borb_n_1st_Countess_of_Vista_Alegre	type	Person
James_I_of_Aragon	type	Person
Arnulf_of_Carinthia	type	Person
Otto_William_Count_of_Burgundy	mother	Gerberga_of_M_con
Igor_of_Kiev	father	Rurik
Claude_of_France	child	Henry_II_of_France
Isabella_of_Portugal_Queen_of_Castile	parent	Isabel_of_Barcelos
Judith_of_Habsburg	father	Rudolf_I_of_Germany
John_Count_of_Angoul_me	type	Person
Walter_archbishop_of_Sens	type	Person
Anne_of_Austria	predecessor	Louis_XIV
Constance_of_Portugal	spouse	Ferdinand_IV_of_Castile
Robert_I_Count_of_Dreux	successor	Robert_II_Count_of_Dreux
Charles_Emmanuel_III_of_Sardinia	child	Victor_Amadeus_III_of_Sardinia
James_Stewart_1st_Earl_of_Moray	type	Person
Margaret_of_Brabant	child	John_of_Bohemia
Marie_of_Anjou	hasSpouse	Yes
Thomas_of_Lancaster_Duke_of_Clarence	spouse	Margaret_Holland_Duchess_of_Clarence
Theobald_of_Arles	hasSpouse	No
Geoffrey_Plantagenet_Count_of_Anjou	mother	Melisende_Queen_of_Jerusalem
Leuthard_I_of_Paris	type	Person
Ginevra_Cavalcanti	spouse	Lorenzo_the_Elder
Albert_I_Duke_of_Bavaria	spouse	Margaret_of_Brieg
John_I_of_Portugal	child	Edward_King_of_Portugal
Francis_II_Holy_Roman_Emperor	child	Archduke_Franz_Karl_of_Austria
Piero_the_Unfortunate	gender	male
Constanza_Manuel	spouse	Alfonso_XI_of_Castile
Robert_II_of_France	child	Hedwig_of_France_Countess_of_Nevers
Joan_II_Countess_of_Burgundy	gender	male
Judith_of_Bavaria_died_843	gender	female
Dangereuse_de_l_Isle_Bouchard	spouse	Aimery_I_Viscount_of_Ch_tellerault
Raymond_of_Burgundy	parent	William_I_Count_of_Burgundy
Charles_Duke_of_Orl_ans	child	Joan_of_Valois_Duchess_of_Alen_on
Margaret_of_France_Queen_of_England_and_Hungary	type	Person
Guillaume_de_Montfort_of_Hainaut	type	Person
Giovanni_delle_Bande_Nere	type	Person
Gerard_de_Bouzonville	hasSpouse	No
Pierfrancesco_the_Elder	name	Pierfrancesco_the_Elder
Joan_of_Valois_Countess_of_Hainaut	child	Margaret_II_Countess_of_Hainaut
William_IV_Duke_of_Aquitaine	parent	William_III_Duke_of_Aquitaine
Adela_of_Milan	type	Person
William_III_Duke_of_Aquitaine	hasSpouse	Yes
Marie_de_Ch_tillon_1323_1363	spouse	Rudolph_Duke_of_Lorraine
Eleanor_of_England_Queen_of_Castile	type	Person
Archduchess_Anna_of_Austria	spouse	Albert_V_Duke_of_Bavaria
Agnes_of_Navarre	type	Person
Isabeau_of_Bavaria	parent	Taddea_Visconti
Claude_of_France	mother	Joan_of_France_Duchess_of_Berry
Philip_III_of_Navarre	child	Philip_Count_of_Longueville
John_King_of_England	spouse	Isabella_Countess_of_Gloucester
Reginar_II_Count_of_Hainaut	hasSpouse	No
Matthew_Stewart_2nd_Earl_of_Lennox	hasSpouse	Yes
Elizabeth_of_Austria_1436_1505	parent	Albert_II_of_Germany
Sophia_of_Istria	spouse	Berthold_II_Count_of_Andechs
Alfonso_XI_of_Castile	hasSpouse	Yes
William_I_Duke_of_Bavaria	type	Person
Rudolph_of_France	predecessor	Robert_I_of_France
Conrad_IV_of_Germany	type	Person
Joan_of_Valois_Countess_of_Hainaut	parent	Margaret_Countess_of_Anjou
Louis_Dauphin_of_France_son_of_Louis_XV	child	Louis_XVIII
Eug_nie_de_Montijo	parent	Cipriano_de_Palafox_8th_Count_of_Montijo
Nicolas_Duke_of_Merc_ur	hasSpouse	Yes
Gerberga_of_Saxony	child	Matilda_of_France
Margaret_of_Geneva	hasSpouse	Yes
Ernest_Augustus_Elector_of_Hanover	child	George_I_of_Great_Britain
Ferdinand_III_of_Castile	type	Person
Henry_II_of_England	type	Person
Stephen_II_Duke_of_Bavaria	parent	Louis_IV_Holy_Roman_Emperor
Francis_I_Holy_Roman_Emperor	predecessor	Leopold_Duke_of_Lorraine
Henrietta_of_England	hasSpouse	Yes
Beatrice_of_Savoy	hasSpouse	Yes
Gisela_of_Burgundy_Marchioness_of_Montferrat	type	Person
Willa_of_Tuscany	predecessor	Ermengarde_of_Tuscany
Elizabeth_the_Cuman	name	Elizabeth_the_Cuman
Frederick_of_Naples	successor	Louis_XII
Sviatoslav_I	child	Oleg_of_Drelinia
Alfonso_X_of_Castile	type	Person
Maredudd_ap_Tudur	name	Maredudd_ap_Tudur
Henry_V_Count_of_Luxembourg	hasSpouse	No
Elisabeth_of_France_1602_1644	gender	female
Boso_the_Elder	father	Boso_II_of_Italy
Henry_of_Bohemia	successor	John_of_Bohemia
Charles_III_of_Spain	spouse	Maria_Amalia_of_Saxony
Marie_Countess_of_Harcourt	hasSpouse	Yes
Mary_of_Hungary_Queen_of_Naples	spouse	Charles_II_of_Naples
Blanche_of_Navarre_Countess_of_Champagne	type	Person
Elizabeth_Gordon_Countess_of_Huntly	gender	female
Maria_Amalia_of_Saxony	gender	female
Prince_Christian_of_Hesse_Darmstadt	type	Person
Louis_the_Stammerer	parent	Ermentrude_of_Orl_ans
Louise_Marie_Ad_la_de_de_Bourbon_Duchess_of_Orl_ans	child	Louis_Philippe_I_Duke_of_Orl_ans
Archduke_Maximilian_Francis_of_Austria	type	Person
Judith_of_Flanders	spouse	_thelwulf_King_of_Wessex
Duchess_Christiane_of_Mecklenburg	type	Person
Fulk_I_Count_of_Anjou	parent	Ingelger
Alfonso_XI_of_Castile	spouse	Constanza_Manuel
Lothair_II_of_Italy	spouse	Adelaide_of_Italy
Peter_I_of_Portugal	type	Person
John_IV_Duke_of_Brittany	gender	male
Otto_II_Duke_of_Bavaria	parent	Louis_I_Duke_of_Bavaria
Henry_III_of_England	spouse	Eleanor_of_Provence
Ad_la_de_d_Orl_ans	type	Person
Constance_of_Arles	child	Robert_I_Duke_of_Burgundy
Matilda_of_Savoy_Queen_of_Portugal	hasSpouse	Yes
Charles_Emmanuel_III_of_Sardinia	spouse	Anne_Christine_of_Sulzbach_Princess_of_Piedmont
Alfonso_II_of_Aragon	parent	Petronilla_of_Aragon
Louis_Dauphin_of_France_son_of_Louis_XV	spouse	Maria_Teresa_Rafaela_of_Spain
William_I_of_Geneva	hasSpouse	Yes
Mary_of_Burgundy_Duchess_of_Cleves	gender	female
Philip_William_Elector_Palatine	hasSpouse	Yes
Sancho_Alfonso	spouse	Beatrice_of_Portugal_died_1381
_thelbald_King_of_Wessex	type	Person
Antoine_Philippe_Duke_of_Montpensier	type	Person
Ferdinand_I_of_the_Two_Sicilies	child	Maria_Clotilde_of_Naples_and_Sicily
George_III	child	Princess_Mary_Duchess_of_Gloucester_and_Edinburgh
Mafalda_of_Portugal	type	Person
Arnulf_Count_of_Holland	predecessor	Dirk_II_Count_of_Holland
Mahaut_of_Ch_tillon	spouse	Charles_Count_of_Valois
Maria_Josepha_of_Saxony_Dauphine_of_France	parent	Maria_Josepha_of_Austria
Margaret_of_Valois_Angoul_me	hasSpouse	Yes
Geoffrey_IV_Count_of_Anjou	type	Person
Margaret_of_Brunswic_L_neburg	type	Person
Ramon_Berenguer_IV_Count_of_Provence	parent	Alfonso_II_Count_of_Provence
Humbert_II_Count_of_Savoy	spouse	Gisela_of_Burgundy_Marchioness_of_Montferrat
Eadhild	spouse	Hugh_the_Great
Matilda_of_Saxony_countess_of_Flanders	hasSpouse	No
Mary_of_Burgundy_Duchess_of_Cleves	spouse	Maximilian_I_Holy_Roman_Emperor
Louis_Count_of__vreux	gender	male
John_I_Count_of_La_Marche	hasSpouse	Yes
John_VII_Duke_of_Mecklenburg_Schwerin	type	Person
Renata_of_Lorraine	predecessor	Archduchess_Anna_of_Austria
Princess_Caroline_Louise_of_Saxe_Weimar_Eisenach	parent	Karl_August_Grand_Duke_of_Saxe_Weimar_Eisenach
Sophia_Eleonore_of_Saxony	spouse	George_II_Landgrave_of_Hesse_Darmstadt
Louise__lisabeth_of_France	gender	female
Bertrada_of_Laon	father	Charibert_of_Laon
Ferdinand_III_of_Castile	mother	Berengaria_of_Castile
Edmund_of_Woodstock_1st_Earl_of_Kent	type	Person
Galeazzo_Maria_Sforza	mother	Polissena_Ruffo
Christine_of_Hesse	parent	Philip_I_Landgrave_of_Hesse
Margaret_Tudor	spouse	James_IV_of_Scotland
Henry_VII_of_England	parent	Lady_Margaret_Beaufort
Charles_IV_of_France	type	Person
Maria_Antonia_Ferdinanda_of_Spain	child	Charles_Felix_of_Sardinia
Ferdinand_I_of_the_Two_Sicilies	predecessor	Charles_III_of_Spain
Robert_II_of_France	predecessor	Hugh_Capet
Robert_I_Count_of_Artois	hasSpouse	No
Berengaria_of_Barcelona	parent	Ramon_Berenguer_III_Count_of_Barcelona
Fran_oise_Madeleine_d_Orl_ans	spouse	Charles_Emmanuel_II_Duke_of_Savoy
John_VIII_Count_of_Vend_me	hasSpouse	No
Philip_III_of_Spain	parent	Philip_II_of_Spain
Albert_I_of_Germany	child	Elisabeth_of_Austria_Duchess_of_Lorraine
Rudolph_II_of_Burgundy	hasSpouse	Yes
Blanche_of_Bourbon	type	Person
Thomas_Stewart_bishop_of_St_Andrews	type	Person
John_Prince_of_Asturias	type	Person
Marie_of_Cleves_Duchess_of_Orl_ans	mother	Mary_of_Burgundy_Duchess_of_Cleves
Alexandre_de_Beauharnais	type	Person
Louis_IX_of_France	child	Margaret_of_France_Duchess_of_Brabant
Lothair_II_of_Italy	predecessor	Hugh_of_Italy
Joan_of_Valois_Countess_of_Hainaut	child	William_II_Count_of_Hainaut
Edmund_Crouchback	type	Person
Beatrice_Regina_della_Scala	type	Person
Piccarda_Bueri	type	Person
James_II_of_Majorca	type	Person
John_IV_Marquis_of_Montferrat	spouse	Margaret_of_Savoy_Countess_of_Saint_Pol
Victor_Amadeus_I_Duke_of_Savoy	successor	Francis_Hyacinth_Duke_of_Savoy
Gisela_Abbess_of_Chelles	type	Person
Casimir_II_the_Just	type	Person
Alys_of_France_Countess_of_Vexin	parent	Eleanor_of_Aquitaine
Archduchess_Anna_of_Austria	successor	Renata_of_Lorraine
Theresa_Countess_of_Portugal	gender	female
Louis_XII	gender	male
Charles_the_Fat	predecessor	Carloman_II
Otto_I_Duke_of_Saxony	spouse	Hedwig_of_Babenberg
Pepin_of_Herstal	mother	Begga
William_Longsword	spouse	Luitgarde_of_Vermandois
Joseph_Bonaparte	type	Person
Sancho_VII_of_Navarre	type	Person
Hugh_Magnus	parent	Rozala_of_Italy
Charles_IV_of_Anjou	predecessor	Ren__of_Anjou
Adolph_I_Duke_of_Cleves	type	Person
Charles_Martel	father	Pepin_of_Herstal
Odo_of_France	hasSpouse	Yes
Leopold_II_Holy_Roman_Emperor	child	Archduke_Anton_Victor_of_Austria
Piero_di_Cosimo_de_Medici	gender	male
Henry_II_of_Castile	type	Person
Charles_VII_of_France	type	Person
Francis_I_of_France	child	Francis_III_Duke_of_Brittany
Antoine_of_Navarre	predecessor	Henry_II_of_Navarre
Violant_of_Hungary	hasSpouse	Yes
Antoinette_of_Bourbon	type	Person
Margaret_of_Valois_Angoul_me	spouse	Henry_II_of_Navarre
Adela_of_Champagne	type	Person
Edward_IV_of_England	spouse	Elizabeth_Woodville
Louis_VII_of_France	predecessor	Louis_VI_of_France
Francesco_I_de_Medici_Grand_Duke_of_Tuscany	parent	Eleanor_of_Toledo
Margaret_Tudor	hasSpouse	Yes
Robert_Count_of_Clermont	parent	Margaret_of_Provence
_lffl_d_wife_of_Edward_the_Elder	child	Edwin_son_of_Edward_the_Elder
Princess_Magdalena_Augusta_of_Anhalt_Zerbst	father	Charles_Prince_of_Anhalt_Zerbst
John_I_Count_of_La_Marche	gender	male
Carlo_Buonaparte	hasSpouse	Yes
Maria_Josepha_of_Austria	name	Maria_Josepha_of_Austria
Beatrice_of_Luxembourg	type	Person
Philip_II_of_Spain	type	Person
John_II_Duke_of_Brittany	gender	male
Elisabeth_of_Sicily_Duchess_of_Bavaria	hasSpouse	Yes
Charles_V_of_France	hasSpouse	Yes
Francis_I_Holy_Roman_Emperor	parent	_lisabeth_Charlotte_d_Orl_ans
William_V_Duke_of_Bavaria	type	Person
Elisabeth_Christine_of_Brunswic_Wolfenb_ttel	child	Maria_Theresa
Catherine_de_Medici	child	Louis_of_Valois
Marie_Countess_of_Ponthieu	successor	Joan_Countess_of_Ponthieu
Philip_IV_of_France	predecessor	Philip_III_of_France
Vladimir_the_Great	child	Mstislav_of_Chernigov
Agnes_of_Burgundy_Duchess_of_Bourbon	parent	Margaret_of_Bavaria
Margaret_of_France_Queen_of_England	type	Person
Charles_Martel	parent	Pepin_of_Herstal
Leopold_III_Duke_of_Austria	spouse	Viridis_Visconti
Haziga_of_Diessen	type	Person
Violant_of_Hungary	child	James_II_of_Majorca
John_Stewart_3rd_Lord_of_Aubigny	type	Person
Peter_I_of_Portugal	child	Maria_of_Portugal_Marchioness_of_Tortosa
Bolko_I_the_Strict	type	Person
Isabella_of_England	type	Person
Sancho_I_of_Portugal	spouse	Dulce_of_Aragon
Countess_Palatine_Caroline_of_Zweibr_cken	mother	Countess_Caroline_of_Nassau_Saarbr_cken
Marie_Countess_of_Ponthieu	hasSpouse	Yes
Bertrade_of_Montfort	parent	Simon_I_de_Montfort
Louis_Philippe_II_Duke_of_Orl_ans	successor	Louis_Philippe_I
Beatrice_of_Portugal	type	Person
Princess_Augusta_of_Saxe_Gotha	child	Princess_Louisa_of_Great_Britain
John_of_Gaunt	father	Edward_III_of_England
John_Stewart_1st_Earl_of_Lennox	hasSpouse	Yes
John_II_of_France	child	Louis_I_of_Anjou
Theobald_I_of_Navarre	parent	Blanche_of_Navarre_Countess_of_Champagne
Diogo_Duke_of_Viseu	type	Person
Raymond_of_Burgundy	predecessor	Nuno_Mendes_count
George_III	father	Frederick_Prince_of_Wales
Marie_Viscountess_of_Limoges	type	Person
Ebalus_Duke_of_Aquitaine	gender	male
James_I_of_Aragon	child	Violant_of_Aragon
Maria_Theresa	child	Maria_Christina_Duchess_of_Teschen
Heinrich_of_Saxe_Weissenfels_Count_of_Barby	type	Person
Conrad_I_Count_of_Auxerre	spouse	Adelaide_of_Tours
Joanna_of_Bourbon	child	Louis_I_Duke_of_Orl_ans
Margaret_Countess_of_Anjou	child	Isabelle_Duchess_of_Brittany
Hugh_Despenser_the_Elder	type	Person
Prince_Frederick_Duke_of_York_and_Albany	type	Person
Anne_Gonzaga	mother	Catherine_of_Mayenne
Charles_I_of_England	spouse	Henrietta_Maria
Henry_I_of_France	successor	Philip_I_of_France
Anne_of_Brittany	parent	Richard_Count_of__tampes
Hedwig_of_France_Countess_of_Mons	type	Person
Elisabeth_of_Nuremberg	mother	Elisabeth_of_Meissen
Barbara_Jagiellon	spouse	George_Duke_of_Saxony
Charlemagne	parent	Pepin_the_Short
Maria_Carolina_of_Austria	child	Prince_Giuseppe_of_Naples_and_Sicily
Ferdinand_I_of_the_Two_Sicilies	child	Luisa_of_Naples_and_Sicily
Rudolf_I_Duke_of_Bavaria	successor	Louis_IV_Holy_Roman_Emperor
Agnes_of_Rochlitz	hasSpouse	Yes
Simon_I_de_Montfort	hasSpouse	No
Wilhelmine_Amalie_of_Brunswick	mother	Benedicta_Henrietta_of_the_Palatinate
Reginald_I_Count_of_Burgundy	mother	Ermentrude_de_Roucy
Hugh_IV_Duke_of_Burgundy	child	Robert_II_Duke_of_Burgundy
Louis_XIV	type	Person
Princess_Louise_of_Hesse_Darmstadt_1757_1830	type	Person
Bonne_of_Luxembourg	mother	Elizabeth_of_Bohemia_1292_1330
Mar_a_Isabella_of_Spain	child	Prince_Francis_Count_of_Trapani
Stephen_II_of_Auxonne	gender	male
Eleanor_of_Aragon_Queen_of_Portugal	hasSpouse	No
Matilda_of_Brabant_Countess_of_Artois	parent	Maria_of_Swabia
Empress_Jos_phine	hasSpouse	Yes
Louis_XII	successor	Ferdinand_II_of_Aragon
James_I_of_Scotland	successor	James_II_of_Scotland
Charles_V_of_France	type	Person
Mary_of_Guise	parent	Claude_Duke_of_Guise
Francis_I_Holy_Roman_Emperor	father	Leopold_Duke_of_Lorraine
Judith_of_Flanders_died_1095	spouse	Welf_I_Duke_of_Bavaria
Charibert_of_Laon	hasSpouse	No
Constance_of_Burgundy	type	Person
Beatrice_of_Castile_Marchioness_of_Montferrat	type	Person
Maria_Carolina_of_Austria	parent	Francis_I_Holy_Roman_Emperor
Christine_of_Saxony	father	George_Duke_of_Saxony
Elisabeth_of_Nuremberg	gender	female
John_IV_Duke_of_Brittany	predecessor	John_of_Montfort
Margaret_of_Flanders_Duchess_of_Brabant	parent	Matilda_of_B_thune
Joan_of__vreux	parent	Louis_Count_of__vreux
Hugh_III_Duke_of_Burgundy	parent	Odo_II_Duke_of_Burgundy
Henry_V_Holy_Roman_Emperor	spouse	Empress_Matilda
Margaret_of_Denmark_Queen_of_Scotland	type	Person
Simon_I_de_Montfort	gender	male
Marie_Ad_la_de_of_Savoy	hasSpouse	No
Francis_II_of_France	parent	Catherine_de_Medici
Guy_Count_of_Flanders	spouse	Matilda_of_B_thune
Louis_VI_of_France	child	Henry_of_France_Archbishop_of_Reims
Reginald_I_Count_of_Burgundy	spouse	Alice_of_Normandy
Joan_I_Countess_of_Auvergne	successor	Philip_I_Duke_of_Burgundy
Catherine_of_Valois	hasSpouse	Yes
James_III_of_Scotland	gender	male
Marie_of_Anjou	parent	Louis_II_of_Anjou
Amadeus_IX_Duke_of_Savoy	type	Person
Isabella_I_of_Castile	parent	Isabella_of_Portugal_Queen_of_Castile
Louis_XVI	spouse	Charles_X
Elisabeth_of_Carinthia_Queen_of_the_Romans	hasSpouse	Yes
Alice_Holland_Countess_of_Kent	parent	Richard_Fitzalan_3rd_Earl_of_Arundel
Louise_Ad_la_de_d_Orl_ans	type	Person
Beatrice_of_Silesia	mother	Beatrice_of_Brandenburg
Margaret_of_Provence	child	Margaret_of_France_Duchess_of_Brabant
James_Gordon_Jesuit	type	Person
Otto_I_Duke_of_Saxony	hasSpouse	Yes
Eckhard_I_Count_of_Scheyern	type	Person
Louis_XII	predecessor	Charles_Duke_of_Orl_ans
Taddea_Visconti	type	Person
Henry_son_of_Robert_I_of_Burgundy	parent	Ermengarde_of_Anjou_Duchess_of_Burgundy
Philippe_Emmanuel_Duke_of_Merc_ur	type	Person
Catherine_de_Medici	type	Person
Dangereuse_de_l_Isle_Bouchard	father	Bartholomew_de_L_Isle_Bouchard
Jeanne_d_Albret	father	Henry_II_of_Navarre
Adolphus_Frederick_I_Duke_of_Mecklenburg_Schwerin	spouse	Anna_Maria_of_Ostfriesland
Charlotte_of_Savoy	parent	Anne_of_Cyprus
David_I_of_Scotland	type	Person
Odo_I_Duke_of_Burgundy	type	Person
Maria_Theresa_of_Austria_Este_Queen_of_Sardinia	parent	Ferdinand_Karl_Archduke_of_Austria_Este
Ferdinand_I_of_the_Two_Sicilies	father	Charles_III_of_Spain
Charles_Emmanuel_IV_of_Sardinia	predecessor	Victor_Amadeus_III_of_Sardinia
Mary_of_Hungary_Queen_of_Naples	child	Louis_of_Toulouse
John_Duke_of_Durazzo	type	Person
Rudolph_III_of_Burgundy	predecessor	Conrad_I_of_Burgundy
Alfonso_VII_of_Le_n_and_Castile	hasSpouse	Yes
Frederick_I_Duke_of_Lorraine	successor	Frederick_II_Duke_of_Lorraine
Francis_II_Duke_of_Brittany	hasSpouse	Yes
Margaret_of_Austria_Duchess_of_Savoy	type	Person
Antoine_Count_of_Vaud_mont	hasSpouse	Yes
Frederick_I_Count_of_Vaud_mont	parent	John_I_Duke_of_Lorraine
Olof_Sk_tkonung	spouse	Estrid_of_the_Obotrites
Otto_I_Duke_of_Brunswic_L_neburg	gender	male
Nicholas_d_Oisy_Lord_of_Avesnes	parent	Walter_I_Lord_of_Avesnes
Bertrade_of_Montfort	father	Simon_I_de_Montfort
Pepin_of_Herstal	successor	Grimoald_the_Younger
Joan_III_Countess_of_Burgundy	hasSpouse	Yes
Francesco_I_de_Medici_Grand_Duke_of_Tuscany	gender	male
John_III_Burgrave_of_Nuremberg	type	Person
Theobald_I_of_Navarre	spouse	Agnes_of_Beaujeu
Sancho_I_of_Portugal	hasSpouse	Yes
John_of_Gaunt	mother	Philippa_of_Hainault
John_II_of_Castile	hasSpouse	Yes
Patrick_Hepburn_3rd_Earl_of_Bothwell	hasSpouse	No
Letgarda_de_Rouergue	type	Person
_lfthryth_Countess_of_Flanders	type	Person
Empress_Matilda	spouse	Henry_V_Holy_Roman_Emperor
Henry_IX_Duke_of_Bavaria	spouse	Wulfhilde_of_Saxony
Maria_Josepha_of_Austria	child	Maria_Amalia_of_Saxony
Magnus_II_Duke_of_Brunswic_L_neburg	hasSpouse	Yes
George_Gordon_4th_Earl_of_Huntly	spouse	Elizabeth_Gordon_Countess_of_Huntly
Louis_I_Duke_of_Bavaria	hasSpouse	Yes
Maria_Beatrice_d_Este_Duchess_of_Massa	parent	Ercole_III_d_Este_Duke_of_Modena
John_I_Duke_of_Brittany	father	Peter_I_Duke_of_Brittany
Francis_I_Duke_of_Lorraine	parent	Antoine_Duke_of_Lorraine
Rudolph_I_of_Burgundy	child	Willa_of_Burgundy
Hugh_of_Italy	type	Person
Lothair_of_France	father	Gilbert_Duke_of_Lorraine
Isabella_of_Portugal_Queen_of_Castile	parent	Maria_of_Aragon_Queen_of_Portugal
Victor_Amadeus_I_Duke_of_Savoy	gender	male
Hugh_II_Duke_of_Burgundy	child	Sibylla_of_Burgundy
Louis_IX_of_France	type	Person
Henry_I_of_France	mother	Constance_of_Arles
Adelaide_of_Maurienne	parent	Gisela_of_Burgundy_Marchioness_of_Montferrat
Duke_Charles_Louis_Frederick_of_Mecklenburg	marriedTo	Princess_Elisabeth_Albertine_of_Saxe_Hildburghausen
James_II_of_Scotland	child	Mary_Stewart_Countess_of_Arran
Elisabeth_Farnese	name	Elisabeth_Farnese
Iziaslav_I_of_Kiev	type	Person
Margaret_of_Provence	type	Person
Henry_I_of_France	type	Person
Eleanor_of_Provence	type	Person
Archduke_Charles_Duke_of_Teschen	type	Person
Antoine_of_Navarre	gender	male
John_King_of_England	father	Eleanor_of_Aquitaine
Mary_Queen_of_Scots	spouse	Francis_II_of_France
Margaret_of_Provence	child	John_Tristan_Count_of_Valois
Constance_of_Arles	spouse	Robert_II_of_France
Maria_Luisa_of_Parma	parent	Louise__lisabeth_of_France
James_III_of_Scotland	predecessor	James_II_of_Scotland
Rudolf_I_of_Germany	child	Otto_III_Duke_of_Bavaria
_thelwulf_King_of_Wessex	type	Person
Amaury_I_de_Montfort	name	Amaury_I_de_Montfort
Joan_of_the_Tower	type	Person
George_Duke_of_Brunswic_Calenberg	hasSpouse	Yes
Magnus_II_Duke_of_Brunswic_L_neburg	parent	Sophia_of_Brandenburg
Francis_I_Holy_Roman_Emperor	predecessor	Charles_VII_Holy_Roman_Emperor
Vladimir_the_Great	parent	Malusha
Gisela_of_Friuli	type	Person
Charles_V_Duke_of_Lorraine	parent	Nicholas_Francis_Duke_of_Lorraine
Urraca_of_Le_n	hasSpouse	Yes
Geoffrey_Count_of_Nantes	type	Person
Muzio_Attendolo_Sforza	hasSpouse	No
Charlemagne	parent	Bertrada_of_Laon
John_II_of_France	successor	Charles_V_of_France
Constance_of_Arles	name	Constance_of_Arles
Odo_of_France	father	Robert_the_Strong
Anne_of_Orl_ans_Abbess_of_Fontevraud	type	Person
Louise_of_Savoy	gender	female
Charles_d_vreux	type	Person
Stephen_Count_of_Blois	spouse	Adela_of_Normandy
Philip_I_of_Castile	spouse	Joanna_of_Castile
Louise_Marie_Anne_de_Bourbon	type	Person
John_Stewart_1st_Earl_of_Lennox	hasSpouse	No
Agnes_of_Rochlitz	type	Person
Princess_Marie_Isabelle_of_Orl_ans	child	Prince_Philippe_Duke_of_Orl_ans_1869_1926
Louis_VII_of_France	father	Matthew_I_of_Montmorency
Stephen_King_of_England	successor	Geoffrey_Plantagenet_Count_of_Anjou
Elisabeth_Christine_of_Brunswic_Wolfenb_ttel	mother	Princess_Christine_Louise_of_Oettinge_Oettingen
Alfonso_X_of_Castile	gender	male
Henry_IV_of_France	spouse	Margaret_of_Valois
Louis_XVII	mother	Charles_X
Ramon_Berenguer_I_Count_of_Barcelona	predecessor	Berenguer_Ramon_I_Count_of_Barcelona
Victor_Amadeus_I_Duke_of_Savoy	child	Princess_Henriette_Adelaide_of_Savoy
Henry_III_of_France	parent	Henry_II_of_France
Berengaria_of_Barcelona	type	Person
Dirk_IV_Count_of_Holland	type	Person
Ladislaus_IV_of_Hungary	type	Person
Emma_of_Italy	father	Lothair_II_of_Italy
Archduchess_Anna_of_Austria	hasSpouse	Yes
Alfonso_II_Count_of_Provence	successor	Ramon_Berenguer_IV_Count_of_Provence
Maria_Christina_of_the_Two_Sicilies	type	Person
Christine_of_Hesse	parent	Christine_of_Saxony
Ren__II_Duke_of_Lorraine	child	Claude_Duke_of_Guise
Henry_I_Duke_of_Brabant	type	Person
Floris_I_Count_of_Holland	spouse	Gertrude_of_Saxony
Alfred_the_Great	parent	Osburh
Marie_of_Anjou	child	Louis_XI
Charles_the_Bold	parent	Isabella_of_Portugal_Duchess_of_Burgundy
Louis_VI_of_France	type	Person
Philip_the_Good	successor	Charles_the_Bold
Eadgifu_of_Wessex	spouse	Charles_the_Simple
Adolphus_Frederick_II_Duke_of_Mecklenburg_Strelitz	child	Duchess_Gustave_Caroline_of_Mecklenburg_Strelitz
Peter_I_Duke_of_Brittany	hasSpouse	No
Marie_of_Luxembourg_Countess_of_Vend_me	gender	female
Eleanor_of_Lancaster	gender	female
Catherine_de_Medici	child	Margaret_of_Valois
Barbara_Jagiellon	gender	female
Margaret_of_Valois_Angoul_me	parent	Charles_Count_of_Angoul_me
Louis_II_Elector_of_Brandenburg	type	Person
Philippa_Countess_of_Toulouse	hasSpouse	Yes
Countess_Palatine_Caroline_of_Zweibr_cken	father	Christian_III_Count_Palatine_of_Zweibr_cken
Agnes_de_Baudemont	type	Person
Napoleon_II	parent	Marie_Louise_Duchess_of_Parma
Godfrey_II_Count_of_Louvain	gender	male
Mary_Tudor_Queen_of_France	type	Person
Otto_I_Duke_of_Saxony	parent	Liudolf_Duke_of_Saxony
John_King_of_England	child	Richard_FitzRoy
Antoine_Duke_of_Lorraine	predecessor	Ren__II_Duke_of_Lorraine
Louis_the_German	successor	Charles_the_Fat
Jean_de_Dunois	type	Person
Simon_I_Duke_of_Lorraine	parent	Hedwig_of_Formbach
Beatrice_of_Savoy	parent	Margaret_of_Geneva
Leopold_II_Holy_Roman_Emperor	successor	Ferdinand_III_Grand_Duke_of_Tuscany
Maria_Beatrice_d_Este_Duchess_of_Massa	child	Maria_Theresa_of_Austria_Este_Queen_of_Sardinia
John_of_Gaunt	predecessor	Richard_II_of_England
In_s_de_Castro	type	Person
Louis_V_of_France	mother	Emma_of_Italy
Eleanor_of_Navarre	gender	female
Archduchess_Maria_Carolina_of_Austria_born_1740	type	Person
Anabella_Drummond	type	Person
John_II_of_Aragon	child	Blanche_II_of_Navarre
Lambert_I_Count_of_Louvain	type	Person
Maria_Anna_Victoria_of_Bavaria	type	Person
Marie_of_Valois_Duchess_of_Calabria	type	Person
Henry_IV_of_France	child	Gaston_Duke_of_Orl_ans
Napoleon_II	parent	Napoleon
Ernest_II_Duke_of_Brunswic_L_neburg	parent	William_the_Younger_Duke_of_Brunswic_L_neburg
Mary_Queen_of_Scots	spouse	Henry_Stuart_Lord_Darnley
Philip_V_of_Spain	mother	Maria_Anna_Victoria_of_Bavaria
Frederick_Prince_of_Wales	father	George_II_of_Great_Britain
Louis_Philippe_II_Duke_of_Orl_ans	spouse	Louise_Marie_Ad_la_de_de_Bourbon_Duchess_of_Orl_ans
Galeazzo_Maria_Sforza	successor	Gian_Galeazzo_Sforza
Charles_Ferdinand_Duke_of_Berry	hasSpouse	Yes
Blanche_of_Brittany	mother	Beatrice_of_England
Countess_Palatine_Caroline_of_Zweibr_cken	child	Prince_Christian_of_Hesse_Darmstadt
Louis_XVI	hasSpouse	No
Charles_Emmanuel_III_of_Sardinia	spouse	Polyxena_of_Hesse_Rotenburg
Louis_XIV	gender	female
Margaret_Lyle	spouse	Matthew_Stewart_2nd_Earl_of_Lennox
Francis_II_Holy_Roman_Emperor	gender	male
Henry_II_of_Castile	parent	Eleanor_de_Guzm_n
John_I_of_Castile	mother	Juana_Manuel
Maria_Beatrice_d_Este_Duchess_of_Massa	mother	Maria_Teresa_Cybo_Malaspina_Duchess_of_Massa
Louis_IX_of_France	child	Philip_III_of_France
James_Stewart_5th_High_Steward_of_Scotland	type	Person
Valdemar_II_of_Denmark	type	Person
Constance_of_Castile	child	Margaret_of_France_Queen_of_England_and_Hungary
Robert_II_of_Scotland	father	Walter_Stewart_6th_High_Steward_of_Scotland
Philippe_II_Duke_of_Orl_ans	parent	Henrietta_of_England
Albert_IV_Count_of_Habsburg	gender	male
Charles_II_Duke_of_Lorraine	spouse	Margaret_of_the_Palatinate
Louis_Philippe_I_Duke_of_Orl_ans	child	Louis_Philippe_II_Duke_of_Orl_ans
Anna_Porphyrogenita	spouse	Vladimir_the_Great
Isabella_of_Portugal_Duchess_of_Burgundy	hasSpouse	Yes
Frederick_II_Count_of_Vaud_mont	parent	Antoine_Count_of_Vaud_mont
Marie_of_Brittany_Lady_of_La_Guerche	type	Person
Mary_of_Burgundy_Duchess_of_Savoy	hasSpouse	Yes
Berengaria_of_Barcelona	gender	female
Carloman_II	gender	male
Hedwig_of_Bavaria	type	Person
Francis_I_of_the_Two_Sicilies	type	Person
William_IX_Duke_of_Aquitaine	spouse	Ermengarde_of_Anjou_d._1146
Afonso_II_of_Portugal	successor	Sancho_II_of_Portugal
Francis_of_Baux	hasSpouse	No
Maximilian_II_Holy_Roman_Emperor	predecessor	Ferdinand_I_Holy_Roman_Emperor
Margaret_of_Savoy_Countess_of_Saint_Pol	spouse	Peter_II_Count_of_Saint_Pol
Alfonso_II_of_Aragon	type	Person
Estrid_of_the_Obotrites	hasSpouse	No
Philip_II_of_France	name	Philip_II
Louis_of_France_1264_1276	type	Person
Richilde_Countess_of_Hainaut	type	Person
Giovanni_il_Popolano	spouse	Caterina_Sforza
Margaret_of_Foix	type	Person
Isabella_I_of_Castile	father	John_II_of_Castile
Philip_II_Duke_of_Savoy	predecessor	Charles_II_Duke_of_Savoy
Alfonso_IX_of_Le_n	hasSpouse	Yes
Beatrice_of_Navarre_Duchess_of_Burgundy	spouse	Hugh_IV_Duke_of_Burgundy
Henry_3rd_Earl_of_Lancaster	type	Person
Henry_the_Lion	gender	male
John_Stewart_3rd_Earl_of_Lennox	gender	male
Lothair_I	type	Person
Theobald_I_Count_of_Blois	type	Person
Henry_the_Middle_Duke_of_Brunswic_L_neburg	parent	Anna_of_Nassau_Dillenburg
Richende_De_Bourges	hasSpouse	No
Blanche_of_Artois	name	Blanche_of_Artois
_lffl_d_wife_of_Edward_the_Elder	hasSpouse	No
Henry_II_of_England	parent	Empress_Matilda
Charlotte_Agla__d_Orl_ans	parent	Philippe_II_Duke_of_Orl_ans
Henry_I_Count_of_Champagne	type	Person
Claude_of_France	predecessor	Anne_of_Brittany
Marie_Louise_Duchess_of_Parma	hasSpouse	No
Baldwin_III_Count_of_Flanders	gender	male
Eckhard_I_Count_of_Scheyern	hasSpouse	Yes
Robert_II_Count_of_Dreux	type	Person
Joan_Countess_of_Ponthieu	predecessor	Marie_Countess_of_Ponthieu
Maria_Theresa_of_Naples_and_Sicily	child	Archduchess_Marie_Anne_of_Austria
Albert_I_of_Germany	spouse	Elisabeth_of_Carinthia_Queen_of_the_Romans
Henry_VII_of_England	predecessor	Richard_III_of_England
Alix_Duchess_of_Brittany	successor	John_I_Duke_of_Brittany
Prince_Adolphus_Duke_of_Cambridge	type	Person
Louis_Count_of__vreux	mother	Marie_of_Brabant_Queen_of_France
Henry_the_Fowler	hasSpouse	Yes
Philippe_I_Duke_of_Orl_ans	child	_lisabeth_Charlotte_d_Orl_ans
Joan_II_Countess_of_Burgundy	parent	Otto_IV_Count_of_Burgundy
Charles_Emmanuel_III_of_Sardinia	child	Princess_Maria_Luisa_of_Savoy_1729_1767
Matilda_of_Frisia	hasSpouse	Yes
Carloman_II	predecessor	Louis_the_Stammerer
Alice_of_Vergy	spouse	Odo_III_Duke_of_Burgundy
Simon_I_de_Montfort	hasSpouse	Yes
Piero_the_Unfortunate	parent	Lorenzo_de_Medici
Louise_of_Great_Britain	type	Person
Louis_V_of_France	predecessor	Lothair_of_France
Henry_the_Lion	mother	Gertrude_of_S_pplingenburg
Radbot_of_Klettgau	type	Person
Joseph_II_Holy_Roman_Emperor	type	Person
Eleanor_of_Aquitaine	child	Eleanor_of_England_Queen_of_Castile
Louis_VIII_of_France	gender	male
Isabeau_of_Bavaria	mother	Taddea_Visconti
John_the_Fearless	parent	Margaret_III_Countess_of_Flanders
John_I_of_Aragon	spouse	Louis_II_of_Anjou
Jacques_of_Savoy_Count_of_Romont	spouse	Marie_of_Luxembourg_Countess_of_Vend_me
Humphrey_de_Bohun_7th_Earl_of_Hereford	type	Person
Frederick_II_Duke_of_Saxe_Gotha_Altenburg	hasSpouse	Yes
Bonne_of_Luxembourg	child	Marie_of_France_Duchess_of_Bar
Gilbert_Duke_of_Lorraine	spouse	Gerberga_of_Saxony
Infante_Carlos_of_Spain_1607_1632	type	Person
Frederick_I_Duke_of_Lorraine	parent	Bertha_Duchess_of_Lorraine
Maria_Amalia_of_Naples_and_Sicily	child	Prince_Louis_Duke_of_Nemours
John_II_Duke_of_Brittany	name	John_II
Pierfrancesco_the_Elder	hasSpouse	No
Walter_Stewart_6th_High_Steward_of_Scotland	parent	James_Stewart_5th_High_Steward_of_Scotland
Geoffrey_Plantagenet_Count_of_Anjou	gender	male
George_I_of_Great_Britain	successor	George_II_of_Great_Britain
Matilda_of_T_bingen	type	Person
Peter_I_Duke_of_Brittany	name	Peter_I
Louis_XVII	hasSpouse	Yes
Louis_XIII	father	Henry_IV_of_France
Prince_Octavius_of_Great_Britain	type	Person
Odo_II_Count_of_Blois	spouse	Maud_of_Normandy
Sophie_of_France_1776_1783	type	Person
Elizabeth_of_York	child	Margaret_Tudor
Pepin_the_Short	father	Charles_Martel
Oleg_of_Drelinia	type	Person
Alfonsina_Orsini	spouse	Piero_the_Unfortunate
Eleanor_of_Lancaster	mother	Maud_Chaworth
Elizabeth_the_Cuman	spouse	Stephen_V_of_Hungary
Princess_Augusta_of_Saxe_Gotha	child	Princess_Augusta_of_Great_Britain
John_VII_Duke_of_Mecklenburg_Schwerin	parent	John_Albert_I_Duke_of_Mecklenburg
Raymond_of_Burgundy	child	Sancha_Raim_ndez
Odo_I_Count_of_Blois	type	Person
Lambert_II_Count_of_Louvain	mother	Gerberga_of_Lower_Lorraine
Elizabeth_of_Bohemia_1292_1330	parent	Judith_of_Habsburg
John_Count_of_Chalon	spouse	Hugh_de_Courtenay
Raymond_of_Burgundy	spouse	Urraca_of_Le_n
Henry_the_Fowler	gender	male
Maria_of_Aragon_Queen_of_Portugal	child	Isabella_of_Portugal
Duchess_Helene_of_Mecklenburg_Schwerin	type	Person
Alfonso_VIII_of_Castile	child	Blanche_of_Castile
Eadburh_of_Winchester	type	Person
Henrietta_Maria	father	Henry_IV_of_France
Joanna_of_Austria_Grand_Duchess_of_Tuscany	father	Ferdinand_I_Holy_Roman_Emperor
Jacquetta_of_Luxembourg	mother	Margaret_of_Baux
Sancho_I_of_Portugal	child	Theresa_of_Portugal_Queen_of_Le_n
Henry_II_of_France	child	Henry_III_of_France
Edward_I_of_England	child	Mary_of_Woodstock
Robert_I_Duke_of_Burgundy	mother	Bertha_of_Burgundy
Joan_Countess_of_Ponthieu	father	Marie_Countess_of_Ponthieu
Beatrice_of_Portugal_died_1381	child	Fernando_S_nchez_2nd_Count_of_Alburquerque
Louis_XIV	parent	Anne_of_Austria
Peter_II_of_Aragon	parent	Sancha_of_Castile_Queen_of_Aragon
Hugh_Capet	spouse	Adelaide_of_Aquitaine
John_Count_of_Chalon	hasSpouse	Yes
John_I_Count_of_Hainaut	gender	male
Frederick_III_Holy_Roman_Emperor	successor	Maximilian_I_Holy_Roman_Emperor
Leopold_III_Duke_of_Austria	mother	Joanna_of_Pfirt
Charles_the_Bold	mother	Bonne_of_Artois
Joan_the_Lame	child	Philip_Duke_of_Orl_ans
Hortense_de_Beauharnais	father	Napoleon
Alfonso_VII_of_Le_n_and_Castile	mother	Urraca_of_Le_n
Anne_of_Bohemia_and_Hungary	mother	Anne_of_Foix_Candale
Richard_Fitzalan_3rd_Earl_of_Arundel	type	Person
Rozala_of_Italy	spouse	Arnulf_II_Count_of_Flanders
Isabella_of_Bourbon	spouse	Charles_the_Bold
Philip_the_Good	predecessor	John_the_Fearless
Afonso_II_of_Portugal	parent	Sancho_I_of_Portugal
Anna_of_Hungary_Byzantine_empress	type	Person
Albert_V_Duke_of_Bavaria	type	Person
Henry_IX_Duke_of_Bavaria	mother	Ethelinde_of_Northeim
Joan_Fitzalan_Countess_of_Hereford	hasSpouse	Yes
Anna_von_Campe	type	Person
_thelwulf_King_of_Wessex	child	_thelstan_of_Kent
Princess_Cl_mentine_of_Orl_ans	type	Person
Beatrice_of_Silesia	hasSpouse	Yes
Alpaida	name	Alpaida
Conrad_I_of_Burgundy	spouse	Matilda_of_France
Peter_I_Duke_of_Bourbon	spouse	Isabella_of_Valois_Duchess_of_Bourbon
Ermentrude_of_Orl_ans	child	Louis_the_Stammerer
Antoine_of_Navarre	type	Person
Rudolph_II_of_Burgundy	successor	Hugh_of_Italy
Charles_Emmanuel_III_of_Sardinia	child	Prince_Vittorio_Amedeo_Teodoro_Duke_of_Aosta
Antonio_de_Medici	type	Person
Christian_III_Count_Palatine_of_Zweibr_cken	spouse	Countess_Caroline_of_Nassau_Saarbr_cken
Francis_I_Duke_of_Lorraine	father	Antoine_Duke_of_Lorraine
Berengar_II_of_Italy	father	Adalbert_I_of_Ivrea
Alfonso_IX_of_Le_n	predecessor	Ferdinand_II_of_Le_n
Maria_Antonia_Ferdinanda_of_Spain	spouse	Victor_Amadeus_III_of_Sardinia
Countess_Palatine_Dorothea_Sophie_of_Neuburg	mother	Landgravine_Elisabeth_Amalie_of_Hesse_Darmstadt
Gerard_Duke_of_Lorraine	parent	Gerard_de_Bouzonville
Wenceslaus_III_of_Bohemia	type	Person
Afonso_IV_of_Portugal	hasSpouse	Yes
Beatriz_Pereira_de_Alvim	hasSpouse	Yes
George_II_of_Great_Britain	predecessor	George_I_of_Great_Britain
Philippe_II_Duke_of_Orl_ans	child	Philippine__lisabeth_d_Orl_ans
John_Stewart_1st_Earl_of_Lennox	gender	male
John_I_of_France	successor	Philip_V_of_France
Lothair_of_France	child	Louis_V_of_France
Francis_Count_of_Vend_me	type	Person
Prince_Philippe_Count_of_Paris	hasSpouse	Yes
Charles_V_Duke_of_Lorraine	mother	Claude_Fran_oise_de_Lorraine
Th_r_se_of_France_1736_1744	type	Person
Marjorie_Bruce	hasSpouse	Yes
Henry_the_Fowler	spouse	Matilda_of_Ringelheim
Anna_of_Holstei_Gottorp	mother	Christine_of_Hesse
Edward_I_of_England	child	Joan_of_Acre
Ferdinand_Philippe_Duke_of_Orl_ans	mother	Louis_Philippe_I_Duke_of_Orl_ans
Henry_III_of_England	predecessor	Louis_VIII_of_France
Malcolm_III_of_Scotland	spouse	Saint_Margaret_of_Scotland
Mahaut_Countess_of_Artois	mother	Amicie_de_Courtenay
Theodoric_II_Duke_of_Lorraine	type	Person
Francesco_III_d_Este_Duke_of_Modena	spouse	Charlotte_Agla__d_Orl_ans
John_II_of_Aragon	parent	Eleanor_of_Alburquerque
Juana_Enr_quez	hasSpouse	Yes
Prince_Maurice_of_Savoy	type	Person
Marie_of_Brabant_Queen_of_France	mother	Adelaide_of_Burgundy_Duchess_of_Brabant
William_Longesp_e_3rd_Earl_of_Salisbury	type	Person
Alfonso_VIII_of_Castile	successor	Henry_I_of_Castile
Joan_I_of_Navarre	father	Henry_I_of_Navarre
Louis_XV	parent	Marie_Ad_la_de_of_Savoy
Princess_Augusta_of_Saxe_Gotha	child	Prince_William_Henry_Duke_of_Gloucester_and_Edinburgh
Sviatoslav_I	type	Person
Urraca_of_Le_n	successor	Alfonso_VII_of_Le_n_and_Castile
George_III	child	Princess_Augusta_Sophia_of_the_United_Kingdom
Ramon_Berenguer_IV_Count_of_Barcelona	parent	Ramon_Berenguer_III_Count_of_Barcelona
Dangereuse_de_l_Isle_Bouchard	hasSpouse	No
Matilda_of_Ringelheim	hasSpouse	Yes
Joanna_of_Castile	mother	Germaine_of_Foix
Antoinette_of_Bourbon	gender	female
Peter_of_Castile	parent	Alfonso_XI_of_Castile
Henry_son_of_Robert_I_of_Burgundy	type	Person
Emma_of_Anjou	type	Person
Ermengarde_of_Hesbaye	gender	female
Rozala_of_Italy	parent	Berengar_II_of_Italy
Margaret_Countess_of_Anjou	child	Joan_of_Valois_Countess_of_Hainaut
Edward_II_of_England	child	Edward_III_of_England
Rudolf_II_Count_of_Habsburg	type	Person
Francis_II_Duke_of_Lorraine	name	Francis_II
Henry_3rd_Earl_of_Lancaster	spouse	Maud_Chaworth
Baldwin_IV_Count_of_Hainaut	spouse	Alice_of_Namur
Arnulf_II_Count_of_Flanders	parent	Matilda_of_Saxony_countess_of_Flanders
Arnulf_I_Count_of_Flanders	hasSpouse	Yes
Alfonso_II_of_Aragon	father	Petronilla_of_Aragon
Henry_IV_of_France	father	Jeanne_d_Albret
Christine_of_Hesse	gender	female
Henry_IV_of_England	predecessor	Richard_II_of_England
William_X_Duke_of_Aquitaine	type	Person
Ermengarde_of_Hesbaye	parent	Ingerman_Count_of_Hesbaye
Isabella_of_Angoul_me	spouse	John_King_of_England
John_Tristan_Count_of_Valois	type	Person
Charles_Emmanuel_I_Duke_of_Savoy	parent	Margaret_of_Valois_Duchess_of_Berry
Engeltrude_de_F_zensac	gender	female
Philippa_of_Luxembourg	spouse	John_II_Count_of_Holland
Theobald_III_Count_of_Champagne	parent	Henry_I_Count_of_Champagne
Maria_Teresa_Felicitas_d_Este	child	Louis_Alexandre_Prince_of_Lamballe
Beatrice_of_Portugal_died_1381	mother	In_s_de_Castro
Philip_III_of_Spain	mother	Anna_of_Austria_Queen_of_Spain
Francis_I_of_the_Two_Sicilies	parent	Ferdinand_I_of_the_Two_Sicilies
Blanche_of_Artois	type	Person
Charles_IV_of_Anjou	type	Person
Richard_Count_of__tampes	mother	Joan_of_Navarre_Queen_of_England
Robert_III_of_Worms	type	Person
Ramon_Berenguer_I_Count_of_Barcelona	type	Person
Antonia_of_Savoy	type	Person
Louis_Philippe_I_Duke_of_Orl_ans	name	Louis_Philippe_I
Agatha_of_Lorraine	type	Person
Maria_Leopoldina_of_Austria	type	Person
Francesco_III_d_Este_Duke_of_Modena	hasSpouse	Yes
Claude_of_France	parent	Anne_of_Brittany
Otto_I_Duke_of_Saxony	type	Person
Robert_II_Duke_of_Burgundy	spouse	Agnes_of_France_Duchess_of_Burgundy
Hedwig_of_Babenberg	type	Person
Ren__II_Duke_of_Lorraine	child	Louis_Count_of_Vaud_mont
Marie_Antoinette	gender	female
Arnulf_II_Count_of_Flanders	mother	Matilda_of_Saxony_countess_of_Flanders
Robert_Count_of_Clermont	hasSpouse	Yes
Albert_IV_Count_of_Habsburg	type	Person
Henry_II_of_England	father	Henry_V_Holy_Roman_Emperor
Princess_Marie_Isabelle_of_Orl_ans	parent	Infanta_Luisa_Fernanda_Duchess_of_Montpensier
Lorenzo_de_Medici_Duke_of_Urbino	mother	Alfonsina_Orsini
Louis_XIII	hasSpouse	Yes
Ealhmund_of_Kent	type	Person
Charles_the_Child	type	Person
Ida_Countess_of_Hainaut	type	Person
Ramon_Borrell_Count_of_Barcelona	hasSpouse	Yes
Francis_Count_of_Vend_me	gender	male
Charles_V_Duke_of_Lorraine	type	Person
Joan_II_Countess_of_Burgundy	parent	Mahaut_Countess_of_Artois
Charlotte_of_Savoy	gender	female
Louis_Philippe_I_Duke_of_Orl_ans	successor	Ferdinand_Philippe_Duke_of_Orl_ans
Baldwin_III_Count_of_Hainaut	gender	male
Maximilian_I_Holy_Roman_Emperor	spouse	Anne_of_Brittany
Charlotte_of_Mecklenburg_Strelitz	child	Princess_Elizabeth_of_the_United_Kingdom
Prince_Ferdinand_Duke_of_Montpensier	predecessor	Antoine_Duke_of_Montpensier
Auguste_of_Bade_Baden	hasSpouse	Yes
Princess_Marie_Isabelle_of_Orl_ans	mother	Infanta_Luisa_Fernanda_Duchess_of_Montpensier
Francis_I_Holy_Roman_Emperor	child	Archduchess_Maria_Carolina_of_Austria_born_1740
Fulk_II_Count_of_Anjou	hasSpouse	Yes
Philip_IV_of_Spain	successor	John_IV_of_Portugal
Maria_Anna_Sophia_of_Saxony	type	Person
Louis_Philippe_I_Duke_of_Orl_ans	mother	Louise_Marie_Ad_la_de_de_Bourbon_Duchess_of_Orl_ans
Princess_Louise_d_Artois	type	Person
Richard_Duke_of_Burgundy	gender	male
Philip_III_of_Spain	spouse	Margaret_of_Austria_Queen_of_Spain
Frederick_Hereditary_Prince_of_Saxony	type	Person
Charles_Duke_of_Orl_ans	father	Louis_I_Duke_of_Orl_ans
Margaret_of_Artois	gender	female
Henry_the_Lion	successor	Otto_I_Duke_of_Bavaria
Henri_Count_of_Chambord	predecessor	Charles_X
Adelaide_of_Aquitaine	child	Robert_II_of_France
Charles_Ferdinand_Duke_of_Berry	father	Charles_X
Isabella_of_Bourbon	type	Person
Manuel_I_of_Portugal	hasSpouse	Yes
Catherine_de_Medici	child	Francis_II_of_France
Henry_VII_Holy_Roman_Emperor	spouse	Margaret_of_Brabant
Antoine_Duke_of_Montpensier	child	Princess_Mar_a_Cristina_of_Orl_ans
Ermengarde_of_Anjou_Duchess_of_Burgundy	hasSpouse	Yes
Beatrice_of_Savoy	gender	female
Dirk_V_Count_of_Holland	type	Person
Engelbert_Duke_of_Carinthia	hasSpouse	Yes
John_I_Duke_of_Brabant	hasSpouse	Yes
Matilda_of_France	father	Louis_IV_of_France
Godfrey_I_Count_of_Louvain	hasSpouse	No
John_I_Duke_of_Lorraine	parent	Marie_de_Ch_tillon_1323_1363
Engelbert_Duke_of_Carinthia	hasSpouse	No
Louis_IX_Landgrave_of_Hesse_Darmstadt	type	Person
Frederick_II_Holy_Roman_Emperor	type	Person
Henri_Count_of_Chambord	spouse	Archduchess_Maria_Theresa_of_Austria_Este_1817_1886
Isabelle_de_Beauvau	type	Person
Engeltrude_de_F_zensac	hasSpouse	Yes
Ferdinand_I_of_the_Two_Sicilies	child	Leopold_Prince_of_Salerno
Maria_of_Austria_Holy_Roman_Empress	child	Archduke_Ernest_of_Austria
Henry_II_of_England	child	John_King_of_England
Lorenzo_de_Medici	hasSpouse	Yes
Matilda_of_Brabant_Countess_of_Artois	gender	female
Margaret_of_Brieg	child	Joanna_of_Bavaria
Frederick_III_Duke_of_Lorraine	predecessor	Matthias_II_Duke_of_Lorraine
Joan_of_Valois_Countess_of_Hainaut	mother	Catherine_I_Latin_Empress
John_of_Bohemia	child	Nicolaus_of_Luxemburg
Welf_I_Duke_of_Bavaria	type	Person
Robert_I_of_France	child	Hugh_the_Great
William_Duke_of_J_lich_Cleves_Berg	spouse	Jeanne_d_Albret
Duchess_Helene_of_Mecklenburg_Schwerin	child	Prince_Robert_Duke_of_Chartres
Matilda_of_B_thune	hasSpouse	Yes
Ramon_Berenguer_IV_Count_of_Barcelona	gender	male
Wilhelmine_Amalie_of_Brunswick	child	Maria_Amalia_Holy_Roman_Empress
Humbert_II_Count_of_Savoy	hasSpouse	Yes
Eleanor_of_Scotland	type	Person
Agnes_of_Burgundy_Duchess_of_Bourbon	predecessor	Marie_Duchess_of_Auvergne
Hortense_de_Beauharnais	gender	female
John_VI_of_Vend_me	spouse	Joan_of_Ponthieu_Dame_of_Epernon
Carlo_Buonaparte	gender	male
Willa_of_Tuscany	mother	Willa_of_Burgundy
Piero_di_Cosimo_de_Medici	mother	Contessina_de_Bardi
Charles_X	gender	male
Elisabeth_of_Meissen	spouse	Frederick_V_Burgrave_of_Nuremberg
Princess_Augusta_of_Saxe_Gotha	parent	Princess_Magdalena_Augusta_of_Anhalt_Zerbst
Berengar_II_of_Italy	child	Rozala_of_Italy
Henry_II_of_Castile	father	Alfonso_XI_of_Castile
Theobald_I_of_Navarre	child	Theobald_II_of_Navarre
Maria_Theresa_of_Spain	type	Person
Bernard_son_of_Charles_Martel	type	Person
Wilhelmine_Amalie_of_Brunswick	parent	John_Frederick_Duke_of_Brunswic_Calenberg
Catherine_of_Valois	spouse	Henry_V_of_England
Edward_III_Duke_of_Bar	type	Person
Elisabeth_of_Nuremberg	type	Person
Baldwin_VI_Count_of_Flanders	type	Person
Louis_Duke_of_Guyenne	type	Person
Maria_Luisa_of_Spain	child	Maria_Theresa_of_Austria_1767_1827
John_II_Count_of_Holland	hasSpouse	Yes
Anne_of_Bohemia_and_Hungary	child	Elizabeth_of_Austria_1526_1545
John_IV_of_Portugal	type	Person
Gisela_of_Burgundy_Marchioness_of_Montferrat	spouse	Rainier_Marquis_of_Montferrat
Philip_V_of_France	mother	Joan_I_of_Navarre
Burkhard_V_Count_of_Hohenberg	hasSpouse	Yes
Princess_Marie_Isabelle_of_Orl_ans	gender	female
Bona_of_Savoy	parent	Louis_Duke_of_Savoy
Sancho_III_of_Castile	type	Person
Margaret_of_Foix	spouse	Richard_Count_of__tampes
Robert_the_Strong	parent	Robert_III_of_Worms
Joanna_of_Castile	successor	Charles_V_Holy_Roman_Emperor
Joan_Beaufort_Queen_of_Scots	hasSpouse	Yes
Charles_Count_of_Valois	child	Isabella_of_Valois_Duchess_of_Bourbon
Clemence_of_Austria	father	Rudolf_I_of_Germany
Bonne_of_Luxembourg	type	Person
Albert_II_Duke_of_Austria	gender	male
Marie_Caroline_of_Bourbo_Two_Sicilies_Duchess_of_Berry	parent	Francis_I_of_the_Two_Sicilies
Charles_X	spouse	Marie_Antoinette
Lothair_of_France	type	Person
Beatrice_of_Silesia	child	Matilda_of_Bavaria_Margravine_of_Meissen
Francis_I_of_the_Two_Sicilies	spouse	Archduchess_Maria_Clementina_of_Austria
Berengar_I_of_Italy	successor	Rudolph_II_of_Burgundy
Eleanor_of_Castile_died_1244	spouse	James_I_of_Aragon
Eleanor_of_Normandy	spouse	Baldwin_IV_Count_of_Flanders
Barbara_of_Cilli	gender	female
Sancho_III_of_Castile	mother	Berengaria_of_Barcelona
Maria_Teresa_Cybo_Malaspina_Duchess_of_Massa	hasSpouse	No
Alderano_I_Cybo_Malaspina	successor	Maria_Teresa_Cybo_Malaspina_Duchess_of_Massa
Fran_oise_Marie_de_Bourbon	gender	female
Matilda_of_Scotland	father	Malcolm_III_of_Scotland
Agnes_of_Burgundy_Duchess_of_Aquitaine	type	Person
Ferdinand_I_of_the_Two_Sicilies	mother	Maria_Amalia_of_Saxony
Eleanor_of_Lancaster	child	Archbishop_of_Canterbury
Antoine_Duke_of_Montpensier	type	Person
Empress_Jos_phine	type	Person
Francis_II_Duke_of_Brittany	spouse	Margaret_of_Foix
Charles_I_Duke_of_Bourbon	spouse	Agnes_of_Burgundy_Duchess_of_Bourbon
Charles_III_Duke_of_Lorraine	father	Francis_I_Duke_of_Lorraine
Carloman_mayor_of_the_palace	type	Person
Alfonso_X_of_Castile	child	John_of_Castile_Lord_of_Valencia_de_Campos
Louis_XVII	type	Person
Werner_I_Count_of_Klettgau	hasSpouse	No
Antoine_Count_of_Vaud_mont	parent	Frederick_I_Count_of_Vaud_mont
Ferdinand_Philippe_Duke_of_Orl_ans	successor	Prince_Philippe_Count_of_Paris
Charles_Count_of_Valois	spouse	Catherine_I_Latin_Empress
Matthew_Stewart_2nd_Earl_of_Lennox	hasSpouse	No
John_I_of_France	predecessor	Louis_X_of_France
Ferdinand_Karl_Archduke_of_Austria_Este	child	Maria_Theresa_of_Austria_Este_Queen_of_Sardinia
Charles_VI_of_France	mother	Joanna_of_Bourbon
George_III	child	William_IV
James_I_of_Scotland	type	Person
Gisela_of_Swabia	type	Person
Arnulf_Count_of_Holland	parent	Dirk_II_Count_of_Holland
Adelaide_of_Auxerre_born_c._870	mother	Waldrada_of_Worms
Blanche_of_Brittany	spouse	Philip_of_Artois
Maria_Amalia_of_Naples_and_Sicily	mother	Maria_Carolina_of_Austria
Charlotte_of_Mecklenburg_Strelitz	hasSpouse	Yes
Ebalus_Duke_of_Aquitaine	type	Person
Charles_VII_of_France	spouse	Marie_of_Anjou
Charles_Martel	predecessor	Theudoald
George_Duke_of_Saxony	type	Person
Frederick_V_Burgrave_of_Nuremberg	spouse	Elisabeth_of_Meissen
Philip_I_of_Castile	hasSpouse	Yes
Isabella_I_of_Castile	child	John_Prince_of_Asturias
Urraca_Afonso	type	Person
Lucia_da_Torsano	type	Person
John_IV_Duke_of_Brittany	mother	John_of_Montfort
Alfonso_II_Count_of_Provence	parent	Sancha_of_Castile_Queen_of_Aragon
James_V_of_Scotland	parent	James_IV_of_Scotland
Margaret_of_Brabant	father	John_I_Duke_of_Brabant
Matilda_of_France	hasSpouse	Yes
Henry_X_Duke_of_Bavaria	spouse	Gertrude_of_S_pplingenburg
Charles_IV_Duke_of_Alen_on	spouse	Margaret_of_Valois_Angoul_me
Charles_VI_of_France	child	Isabella_of_Valois_Duchess_of_Bourbon
Pepin_I_of_Aquitaine	predecessor	Louis_the_Pious
Godfrey_I_Count_of_Louvain	hasSpouse	Yes
Maria_Josepha_of_Austria	child	Maria_Kunigunde_of_Saxony
Marie_Antoinette	hasSpouse	No
Ingeborg_of_Denmark_Queen_of_France	parent	Sophia_of_Minsk
Theresa_Countess_of_Portugal	successor	Afonso_I_of_Portugal
Maria_of_Montpellier	type	Person
Landgravine_Elisabeth_Amalie_of_Hesse_Darmstadt	mother	Sophia_Eleonore_of_Saxony
Waldrada_of_Worms	type	Person
Isabella_Duchess_of_Lorraine	child	Yolande_Duchess_of_Lorraine
Margaret_of_Bourbon_Queen_of_Navarre	spouse	Theobald_I_of_Navarre
Gertrude_of_Saxony	parent	Bernard_II_Duke_of_Saxony
Louis_Dauphin_of_France_son_of_Louis_XIV	type	Person
Fran_oise_Marie_de_Bourbon	hasSpouse	Yes
Robert_I_Duke_of_Burgundy	hasSpouse	Yes
Yolande_of_Dreux_Duchess_of_Burgundy	type	Person
Isabella_I_of_Castile	child	Isabella_of_Aragon_Queen_of_Portugal
Philip_the_Good	hasSpouse	Yes
Isabel_of_Coimbra	hasSpouse	No
Bertrada_of_Laon	parent	Charibert_of_Laon
Mary_Queen_of_Scots	type	Person
Herbert_III_of_Omois	type	Person
Ferdinand_II_of_Aragon	gender	male
James_II_of_Scotland	child	James_III_of_Scotland
Dorothea_of_Denmark_Duchess_of_Brunswic_L_neburg	hasSpouse	Yes
Isabella_of_France	father	Philip_IV_of_France
Prince_Philippe_Count_of_Paris	predecessor	Ferdinand_Philippe_Duke_of_Orl_ans
Charles_I_Gonzaga_Duke_of_Mantua	type	Person
Amadeus_VIII_Duke_of_Savoy	parent	Bonne_of_Berry
Charles_the_Fat	predecessor	Charles_the_Bald
Blanche_of_Burgundy	type	Person
Philip_II_of_France	parent	Eleanor_of_Aquitaine
Willa_of_Tuscany	successor	Adelaide_of_Italy
Matilda_of_Brabant_Countess_of_Artois	hasSpouse	No
Blanche_of_Navarre_Queen_of_France	mother	Joan_II_of_Navarre
Joan_II_Countess_of_Burgundy	mother	Mahaut_Countess_of_Artois
Adelaide_of_Auxerre_born_c._870	hasSpouse	No
Guisla_de_Llu__	type	Person
John_I_Duke_of_Lorraine	child	Frederick_I_Count_of_Vaud_mont
Christina_of_Salm	hasSpouse	Yes
Marie_Jos_phine_of_Savoy	hasSpouse	Yes
Blanche_of_Burgundy	gender	female
Henry_the_Fowler	parent	Otto_I_Duke_of_Saxony
Matilda_of_Saxony_countess_of_Flanders	hasSpouse	Yes
Louis_Philippe_I_Duke_of_Orl_ans	parent	Louis_Duke_of_Orl_ans_1703_1752
Albert_IV_Count_of_Habsburg	parent	Rudolf_II_Count_of_Habsburg
Margaret_Stewart_Dauphine_of_France	father	James_Stewart_the_Black_Knight_of_Lorn
Prince_Alberto_of_Naples_and_Sicily	type	Person
In_s_de_Castro	parent	Pedro_Fern_ndez_de_Castro
William_III_of_M_con	parent	Stephen_I_Count_of_Burgundy
Gertrude_of_Flanders_Duchess_of_Lorraine	spouse	Theodoric_II_Duke_of_Lorraine
Louis_I_Duke_of_Bourbon	hasSpouse	Yes
Ferdinand_of_Portugal_Duke_of_Guarda	type	Person
Elisabeth_Farnese	parent	Odoardo_Farnese_Hereditary_Prince_of_Parma
Wierzchoslawa_Ludmilla_of_Greater_Poland	hasSpouse	No
Joan_I_of_Navarre	child	Philip_V_of_France
Ingegerd_Olofsdotter_of_Sweden	child	Anastasia_of_Kiev
Bona_of_Savoy	child	Bianca_Maria_Sforza
Louis_XV	child	Victoire_of_France_1733_1799
Margaret_of_Geneva	hasSpouse	No
Marie_Countess_of_Ponthieu	gender	female
Louis_Philippe_I_Duke_of_Orl_ans	spouse	Madame_de_Montesson
Richilde_Countess_of_Hainaut	hasSpouse	Yes
Theobald_I_of_Navarre	spouse	Gertrude_of_Dagsburg
Antoine_Duke_of_Montpensier	successor	Prince_Ferdinand_Duke_of_Montpensier
Ermentrude_of_Orl_ans	parent	Odo_I_Count_of_Orl_ans
Bona_of_Savoy	spouse	Galeazzo_Maria_Sforza
Elisabeth_Christine_of_Brunswic_Wolfenb_ttel	gender	female
William_I_Count_of_Hainaut	mother	Philippa_of_Luxembourg
Margaret_of_Geneva	name	Margaret_of_Geneva
Philip_of_France_1116_1131	mother	Lucienne_of_Rochefort
Robert_I_Latin_Emperor	type	Person
Louis_IX_of_France	predecessor	Louis_VIII_of_France
Philip_II_Duke_of_Savoy	child	Ren__of_Savoy
Robert_III_of_Worms	name	Robert_III_of_Worms
Cardinal_Infante_Ferdinand_of_Austria	type	Person
Oleg_of_Novgorod	successor	Igor_of_Kiev
Louis_the_Pious	parent	Charlemagne
Giuseppe_Maria_Buonaparte	type	Person
Elizabeth_of_Luxembourg	parent	Barbara_of_Cilli
Henry_VII_Holy_Roman_Emperor	parent	Henry_VI_Count_of_Luxembourg
Gertrude_of_Hohenberg	child	Judith_of_Habsburg
Louis_IV_Holy_Roman_Emperor	spouse	Margaret_II_Countess_of_Hainaut
Schweinfurt	hasSpouse	Yes
James_V_of_Scotland	spouse	Madeleine_of_Valois
Leopold_III_Duke_of_Austria	successor	William_Duke_of_Austria
Leuthard_I_of_Paris	hasSpouse	Yes
Maximilian_Sforza	type	Person
Welf_I_Duke_of_Bavaria	spouse	Ethelinde_of_Northeim
Rudolph_of_France	successor	Louis_IV_of_France
Beatrice_of_England	child	Marie_of_Brittany_Countess_of_Saint_Pol
Louis_Count_of__vreux	parent	Isabella_of_Aragon_Queen_of_France
Charles_the_Bald	parent	Louis_the_Pious
Berengar_II_of_Neustria	type	Person
Henry_VI_Count_of_Luxembourg	predecessor	Henry_V_Count_of_Luxembourg
Baldwin_II_Count_of_Hainaut	spouse	Ida_Countess_of_Hainaut
Theodoric_II_Duke_of_Lorraine	successor	Simon_I_Duke_of_Lorraine
Ramon_Borrell_Count_of_Barcelona	gender	male
Th_odrate_of_Troyes	type	Person
William_IV_Duke_of_Aquitaine	mother	Gerloc
Joan_Beaufort_Queen_of_Scots	spouse	James_I_of_Scotland
Afonso_II_of_Portugal	child	Eleanor_of_Portugal_Queen_of_Denmark
John_I_of_Castile	spouse	Eleanor_of_Aragon_Queen_of_Castile
Bivin_of_Gorze	hasSpouse	Yes
Edgar__theling	type	Person
Joan_II_of_Navarre	child	Maria_of_Navarre
Sigismund_II_Augustus	type	Person
Joan_of_Ponthieu_Dame_of_Epernon	hasSpouse	No
Mstislav_of_Chernigov	type	Person
Maria_Teresa_Felicitas_d_Este	spouse	Louis_Jean_Marie_de_Bourbon_Duke_of_Penthi_vre
Ferdinand_Duke_of_Viseu	child	Isabel_of_Viseu
Henry_I_of_France	child	Philip_I_of_France
Alfonso_VIII_of_Castile	mother	Blanca_of_Navarre_Queen_of_Castile
Engeltrude_de_F_zensac	parent	Leuthard_I_of_Paris
William_IV_Duke_of_Aquitaine	parent	Gerloc
Francis_I_Holy_Roman_Emperor	child	Archduchess_Maria_Josepha_of_Austria
Maria_of_Swabia	spouse	Henry_II_Duke_of_Brabant
Lorenzo_de_Medici_Duke_of_Urbino	parent	Alfonsina_Orsini
Ferdinand_II_of_Le_n	spouse	Urraca_of_Portugal
Eilika_of_Schweinfurt	hasSpouse	No
Philip_Duke_of_Nemours	type	Person
Henry_II_of_England	father	Geoffrey_Plantagenet_Count_of_Anjou
Hugh_the_Great	parent	Beatrice_of_Vermandois
Emma_of_France	spouse	Rudolph_of_France
Denis_of_Portugal	parent	Afonso_III_of_Portugal
Adalbert_I_of_Ivrea	type	Person
Countess_Caroline_of_Nassau_Saarbr_cken	gender	female
Maria_of_Austria_Duchess_of_J_lich_Cleves_Berg	parent	Anne_of_Bohemia_and_Hungary
Henry_VI_of_England	parent	Henry_V_of_England
Princess_Elisabeth_Albertine_of_Saxe_Hildburghausen	hasSpouse	Yes
John_Stewart_Earl_of_Mar_died_1479	type	Person
Gisela_of_Burgundy_Marchioness_of_Montferrat	parent	Conrad_I_of_Burgundy
James_I_of_Aragon	child	Peter_III_of_Aragon
Berthold_Duke_of_Merania	parent	Berthold_I_of_Istria
Joan_I_Countess_of_Auvergne	type	Person
Louis_VI_of_France	spouse	Adelaide_of_Maurienne
John_IV_Duke_of_Brittany	child	Marie_of_Brittany_Lady_of_La_Guerche
John_VIII_Count_of_Vend_me	gender	male
Giuliano_de_Medici_Duke_of_Nemours	successor	Lorenzo_de_Medici_Duke_of_Urbino
Edward_I_of_England	child	Edward_II_of_England
Anne_Queen_of_Great_Britain	successor	George_I_of_Great_Britain
Elisabeth_of_Hesse_Electress_Palatine	type	Person
Marie_Duchess_of_Auvergne	type	Person
Louis_XV	hasSpouse	Yes
John_II_Duke_of_Brittany	type	Person
_lffl_d_wife_of_Edward_the_Elder	type	Person
Charles_Martel	type	Person
Maximilian_II_Holy_Roman_Emperor	father	Ferdinand_I_Holy_Roman_Emperor
Theobald_I_of_Navarre	hasSpouse	Yes
Leopold_II_Holy_Roman_Emperor	child	Francis_II_Holy_Roman_Emperor
Eleanor_of_Aquitaine	parent	William_X_Duke_of_Aquitaine
William_IV_Duke_of_Aquitaine	gender	male
Luitgarde_of_Vermandois	hasSpouse	No
Charles_VIII_of_France	successor	Louis_XII
Joan_II_of_Navarre	gender	male
Eleanor_of_Aragon_Queen_of_Portugal	child	Joan_of_Portugal
Francis_I_Holy_Roman_Emperor	child	Leopold_II_Holy_Roman_Emperor
Elizabeth_Woodville	gender	female
Beatrice_of_Portugal_died_1381	mother	Teresa_Louren_o
Anne_of_Bohemia_Duchess_of_Austria	type	Person
Eleanor_of_Portugal_Holy_Roman_Empress	hasSpouse	Yes
Nicolas_Duke_of_Merc_ur	hasSpouse	No
Otto_II_Count_of_Habsburg	hasSpouse	No
Henry_III_of_England	hasSpouse	Yes
John_of_Gaunt	child	John_Beaufort_1st_Earl_of_Somerset
Berengaria_of_Castile	gender	male
Pepin_the_Short	mother	Rotrude_of_Hesbaye
Sancho_I_of_Portugal	parent	Matilda_of_Savoy_Queen_of_Portugal
Yolanda_Latin_Empress	father	Baldwin_V_Count_of_Hainaut
Maria_of_Aragon_Queen_of_Portugal	mother	Germaine_of_Foix
Princess_Magdalena_Augusta_of_Anhalt_Zerbst	child	Johann_Adolf_of_Saxe_Gotha_Altenburg
Louis_I_Duke_of_Bavaria	parent	Otto_I_Duke_of_Bavaria
Joan_II_Countess_of_Burgundy	father	Mahaut_Countess_of_Artois
Luisa_Carlotta_of_the_Two_Sicilies	type	Person
Louis_Philippe_II_Duke_of_Orl_ans	child	Louis_Charles_Count_of_Beaujolais
Yolande_of_Aragon	hasSpouse	Yes
Matilda_of_Saxony_1172_1209/10	type	Person
Edward_II_of_England	child	Eleanor_of_Woodstock
Henry_I_Duke_of_Brabant	spouse	Marie_of_France_Duchess_of_Brabant
Frederick_Prince_of_Wales	hasSpouse	Yes
Alan_Stewart_of_Darnley	parent	John_Stewart_of_Darnley
Gerard_Duke_of_Lorraine	predecessor	Adalbert_Duke_of_Lorraine
Blanche_of_Castile	spouse	Louis_VIII_of_France
Viridis_Visconti	spouse	Leopold_III_Duke_of_Austria
Charles_Martel	successor	Carloman_mayor_of_the_palace
Louis_XV	child	Louis_Dauphin_of_France_son_of_Louis_XV
Auda_of_France	type	Person
Desiderius	successor	Charlemagne
Anne_of_Bohemia_and_Hungary	child	Catherine_of_Austria_Queen_of_Poland
French_Revolution_of_1848	type	Person
Robert_II_Duke_of_Burgundy	successor	Hugh_V_Duke_of_Burgundy
Ferdinand_II_of_Aragon	spouse	Germaine_of_Foix
John_II_of_France	father	Philip_VI_of_France
Robert_II_of_France	spouse	Rozala_of_Italy
Elisabeth_of_France_1602_1644	father	Henry_IV_of_France
Charles_I_of_Anjou	type	Person
Francis_IV_Duke_of_Modena	child	Archduke_Ferdinand_Karl_Viktor_of_Austria_Este
Frederick_III_Duke_of_Lorraine	hasSpouse	No
Louis_VIII_of_France	child	Louis_IX_of_France
Louis_Duke_of_Orl_ans_1703_1752	mother	Fran_oise_Marie_de_Bourbon
Charles_VII_of_France	child	Magdalena_of_Valois
Afonso_I_of_Portugal	gender	male
Thierry_Count_of_Flanders	hasSpouse	Yes
Albert_Azzo_II_Margrave_of_Milan	gender	male
John_of_Montfort	mother	Yolande_of_Dreux_Queen_of_Scotland
Robert_III_of_Scotland	parent	Elizabeth_Mure
Charlemagne	type	Person
Mary_Queen_of_Scots	parent	James_V_of_Scotland
Stephen_III_Duke_of_Bavaria	spouse	Elisabeth_of_Cleves
Pepin_the_Short	predecessor	Carloman_mayor_of_the_palace
Marie_of_France_Duchess_of_Bar	child	Violant_of_Bar
Margaret_of_Provence	father	Ramon_Berenguer_IV_Count_of_Provence
Richard_Duke_of_Burgundy	spouse	Adelaide_of_Auxerre_born_c._870
Edward_the_Elder	child	Edith_of_Polesworth
Margaret_of_Brieg	father	Louis_I_of_Brzeg
John_I_Duke_of_Brittany	parent	Peter_I_Duke_of_Brittany
Joan_Holland_Duchess_of_Brittany	type	Person
Bouchard_IV_of_Avesnes	hasSpouse	Yes
Frederick_IV_Duke_of_Lorraine	spouse	Elisabeth_of_Austria_Duchess_of_Lorraine
Charles_V_of_France	child	Charles_VI_of_France
Charles_Duke_of_Orl_ans	name	Charles
Charles_Duke_of_Orl_ans	spouse	Isabella_of_Valois_Duchess_of_Bourbon
Joanna_of_Pfirt	type	Person
John_Frederick_Duke_of_Brunswic_Calenberg	spouse	Benedicta_Henrietta_of_the_Palatinate
Philippe_II_Duke_of_Orl_ans	hasSpouse	Yes
Ermentrude_of_Orl_ans	child	Charles_the_Child
Hermann_II_Count_of_Celje	type	Person
Elizabeth_Woodville	type	Person
Judith_of_Habsburg	spouse	Wenceslaus_II_of_Bohemia
Philip_V_of_France	child	Isabella_of_France_Dauphine_of_Viennois
Giovanni_il_Popolano	hasSpouse	No
Wenceslaus_II_of_Bohemia	hasSpouse	Yes
Frederick_V_Burgrave_of_Nuremberg	hasSpouse	Yes
Gertrude_of_Hohenberg	child	Rudolf_II_Duke_of_Austria
Charles_IX_of_France	hasSpouse	Yes
John_I_of_Portugal	father	Peter_I_of_Portugal
Maria_Theresa_of_Spain	parent	Philip_IV_of_Spain
Ferdinand_I_of_the_Two_Sicilies	child	Maria_Anna_of_Naples_and_Sicily
Galeazzo_Maria_Sforza	mother	Bianca_Maria_Visconti
Archduke_Maximilian_Ernest_of_Austria	type	Person
Charles_VII_of_France	child	Joan_of_France_Duchess_of_Bourbon
Charles_Emmanuel_III_of_Sardinia	successor	Victor_Amadeus_III_of_Sardinia
John_the_Fearless	child	Anne_of_Burgundy
Afonso_II_of_Portugal	father	Sancho_I_of_Portugal
Marged_ferch_Tomos	type	Person
Stephen_II_Duke_of_Bavaria	child	John_II_Duke_of_Bavaria
Eleanor_of_Alburquerque	parent	Sancho_Alfonso
Engeltrude_de_F_zensac	hasSpouse	No
Joan_the_Lame	hasSpouse	Yes
Adolf_Duke_of_Holstei_Gottorp	hasSpouse	Yes
Margaret_of_Brieg	child	William_II_Duke_of_Bavaria
Sancha_Raim_ndez	type	Person
Henry_II_of_Castile	spouse	Juana_Manuel
Vladimir_the_Great	child	Maria_Dobroniega_of_Kiev
Alice_of_Vergy	hasSpouse	Yes
Maria_of_Austria_Holy_Roman_Empress	child	Rudolf_II_Holy_Roman_Emperor
Matthew_Count_of_Boulogne	type	Person
James_III_of_Scotland	child	James_Stewart_Duke_of_Ross
Isabella_I_of_Castile	parent	John_II_of_Castile
Philip_VI_of_France	father	Margaret_Countess_of_Anjou
Otto_I_Holy_Roman_Emperor	parent	Henry_the_Fowler
Mar_a_Cristina_Mu_oz_y_Borb_n_Marquise_of_la_Isabela	type	Person
Pope	name	Pope
Louis_Count_of_Vend_me	mother	Catherine_of_Vend_me
Louis_XVI	child	Sophie_of_France_1786_1787
Charlotte_de_Br_z_	type	Person
John_I_of_France	hasSpouse	Yes
Elisabeth_Farnese	parent	Countess_Palatine_Dorothea_Sophie_of_Neuburg
William_V_Duke_of_Aquitaine	type	Person
Claude_of_France	hasSpouse	Yes
Yaroslav_the_Wise	child	Igor_Yaroslavich
Rudolf_II_Count_of_Habsburg	hasSpouse	No
Louis_XII	type	Person
Maria_Theresa_of_Naples_and_Sicily	type	Person
Henry_VII_of_England	gender	male
Henry_II_of_France	child	Francis_Duke_of_Anjou
Ferdinand_of_Castile_born_1238	type	Person
Christina_of_Salm	spouse	Francis_II_Duke_of_Lorraine
Antoine_Duke_of_Lorraine	hasSpouse	Yes
Amicie_de_Courtenay	gender	female
Ferdinand_I_of_the_Two_Sicilies	child	Maria_Cristina_of_Naples_and_Sicily
Rudolph_Duke_of_Lorraine	father	Frederick_IV_Duke_of_Lorraine
Beatrice_of_Savoy	child	Sanchia_of_Provence
Ermengarde_of_Auvergne	type	Person
Afonso_III_of_Portugal	spouse	Matilda_II_Countess_of_Boulogne
William_de_Beauchamp_9th_Earl_of_Warwick	spouse	Maud_FitzJohn_Countess_of_Warwick
Mary_of_Guise	hasSpouse	Yes
Polyxena_of_Hesse_Rotenburg	hasSpouse	Yes
Peter_I_of_Portugal	predecessor	Afonso_IV_of_Portugal
Maria_Anna_of_Bavaria_born_1551	parent	Archduchess_Anna_of_Austria
Infanta_Luisa_Fernanda_Duchess_of_Montpensier	type	Person
Simon_I_de_Montfort	predecessor	Amaury_I_de_Montfort
Francis_I_Holy_Roman_Emperor	child	Archduchess_Maria_Elisabeth_of_Austria_born_1737
Clementia_of_Hungary	hasSpouse	Yes
John_II_of_Aragon	successor	Eleanor_of_Navarre
Sancho_IV_of_Castile	predecessor	Alfonso_X_of_Castile
Rudolf_I_of_Germany	gender	male
Wulfoald	successor	Pepin_of_Herstal
Garzia_de_Medici	type	Person
Francis_II_Holy_Roman_Emperor	child	Marie_Louise_Duchess_of_Parma
Katherine_of_Bavaria	type	Person
Peter_Tempesta	type	Person
Anne_of_Foix_Candale	child	Louis_II_of_Hungary
Fulk_IV_Count_of_Anjou	parent	Robert_I_Duke_of_Burgundy
Frederick_Prince_of_Wales	gender	male
Henry_VIII	parent	Henry_VII_of_England
Francis_II_Duke_of_Lorraine	hasSpouse	Yes
Albert_II_of_Germany	successor	Frederick_III_Holy_Roman_Emperor
William_I_Count_of_Burgundy	hasSpouse	Yes
Philip_V_of_France	spouse	Joan_II_Countess_of_Burgundy
Maria_Josepha_of_Saxony_Dauphine_of_France	father	Augustus_III_of_Poland
Jacquetta_of_Luxembourg	hasSpouse	No
Robert_II_of_France	type	Person
Carlo_Buonaparte	hasSpouse	No
Herbert_III_of_Omois	spouse	Eadgifu_of_Wessex
Eleanor_de_Guzm_n	hasSpouse	Yes
Margaret_of_the_Palatinate	gender	female
Dirk_II_Count_of_Holland	hasSpouse	Yes
Eug_nie_de_Montijo	mother	Mar_a_Manuela_Kirkpatrick_de_Grevign_e
Archduchess_Anna_of_Austria	child	Ferdinand_of_Bavaria_soldier
Charles_Martel	child	Remigius_of_Rouen
Joan_of__vreux	mother	Margaret_of_Artois
Fran_oise_Marie_de_Bourbon	spouse	Philippe_II_Duke_of_Orl_ans
Isabella_of_Bourbon	gender	female
Louise_of_Savoy	spouse	Charles_Count_of_Angoul_me
Baldwin_V_Count_of_Hainaut	mother	Alice_of_Namur
Cymburgis_of_Masovia	type	Person
Matilda_of_Bavaria_Margravine_of_Meissen	mother	Beatrice_of_Silesia
Christine_of_Hesse	name	Christine_of_Hesse
Berenguer_Ramon_I_Count_of_Barcelona	parent	Ermesinde_of_Carcassonne
Ernest_Duke_of_Austria	successor	Frederick_III_Holy_Roman_Emperor
Marie_de_Valois	type	Person
Sophia_of_Minsk	father	Volodar_Glebovich_Prince_of_Minsk
Henry_IV_of_England	type	Person
Charles_V_Holy_Roman_Emperor	spouse	Isabella_of_Portugal_Queen_of_Castile
Isabella_of_Valois_Duchess_of_Bourbon	parent	Charles_Count_of_Valois
Francis_I_of_France	spouse	Claude_of_France
Mary_of_Hungary_Queen_of_Naples	type	Person
Princess_Augusta_of_Great_Britain	type	Person
Philippa_of_Hainault	spouse	Edward_III_of_England
Philip_V_of_France	parent	Philip_IV_of_France
Elisabeth_of_France_1602_1644	child	Maria_Theresa_of_Spain
Joan_Holland_Duchess_of_Brittany	spouse	John_IV_Duke_of_Brittany
Fran_oise_Marie_de_Bourbon	father	Louis_Henri_de_Pardaillan_de_Gondrin
Bernab__Visconti	type	Person
Beatriz_Pereira_de_Alvim	mother	Leonor_de_Alvim
Ingegerd_Olofsdotter_of_Sweden	spouse	Yaroslav_the_Wise
Margaret_of_Brieg	spouse	Albert_I_Duke_of_Bavaria
Catherine_of_Foix_Countess_of_Candale	spouse	Gaston_de_Foix_Count_of_Candale
Louis_of_Valois	type	Person
Hortense_de_Beauharnais	mother	Empress_Jos_phine
John_of_Gaunt	child	Joan_Beaufort_Countess_of_Westmorland
Joan_Fitzalan_Countess_of_Hereford	parent	Richard_Fitzalan_3rd_Earl_of_Arundel
Bernhard_Count_of_Anhalt	type	Person
Charles_the_Fat	successor	Odo_of_France
Thomas_Arundel	type	Person
Joanna_of_Castile	child	Ferdinand_I_Holy_Roman_Emperor
Robert_II_of_France	hasSpouse	No
Ferdinand_I_Holy_Roman_Emperor	child	Maria_of_Austria_Duchess_of_J_lich_Cleves_Berg
Louis_III_of_France	parent	Louis_the_Stammerer
Alfonsina_Orsini	hasSpouse	Yes
Reginar_II_Count_of_Hainaut	gender	male
William_XII_Count_of_Auvergne	type	Person
William_IX_Duke_of_Aquitaine	type	Person
Berengaria_of_Barcelona	parent	Douce_I_Countess_of_Provence
Hugh_IV_Duke_of_Burgundy	child	Isabella_of_Burgundy_Queen_of_Germany
Edward_King_of_Portugal	child	Joan_of_Portugal
Philip_III_of_France	successor	Philip_IV_of_France
Francis_I_Holy_Roman_Emperor	child	Joseph_II_Holy_Roman_Emperor
Bertha_of_Burgundy	parent	Conrad_I_of_Burgundy
Yolanda_Latin_Empress	child	Maria_of_Courtenay
Edward_Count_Palatine_of_Simmern	hasSpouse	Yes
Charles_the_Fat	predecessor	Louis_the_German
Beatrice_of_Silesia	father	Bolko_I_the_Strict
Liudolf_Duke_of_Saxony	hasSpouse	No
Blanche_of_Navarre_Countess_of_Champagne	spouse	Theobald_III_Count_of_Champagne
Philippa_of_Hainault	parent	William_I_Count_of_Hainaut
John_I_of_Aragon	type	Person
Isabella_of_Hainault	hasSpouse	Yes
John_of_Gaunt	child	Philippa_of_Lancaster
Odo_II_Count_of_Blois	parent	Odo_I_Count_of_Blois
George_I_of_Great_Britain	hasSpouse	Yes
Marie_Eleonore_of_Cleves	child	Magdalene_Sibylle_of_Prussia
Isabella_Duchess_of_Lorraine	predecessor	Charles_II_Duke_of_Lorraine
Odo_IV_Duke_of_Burgundy	parent	Robert_II_Duke_of_Burgundy
Louis_IV_Holy_Roman_Emperor	type	Person
Hugh_the_Great	gender	male
Rozala_of_Italy	hasSpouse	Yes
Louis_the_Pious	child	Louis_the_German
Anna_of_Holstei_Gottorp	type	Person
Odo_I_Duke_of_Burgundy	gender	male
Violant_of_Aragon	type	Person
Clemens_Wenceslaus_of_Saxony	type	Person
Charles_VII_of_France	parent	Charles_VI_of_France
Bona_of_Savoy	child	Hermes_Maria_Sforza
Letizia_Bonaparte	hasSpouse	Yes
Richilde_Countess_of_Hainaut	spouse	Baldwin_VI_Count_of_Flanders
James_II_of_England	type	Person
Joanna_of_Aragon_Queen_of_Naples	type	Person
Theobald_III_Count_of_Blois	hasSpouse	Yes
Odo_II_Count_of_Blois	father	Robert_II_of_France
Henry_of_France_Archbishop_of_Reims	type	Person
Margaret_of_Anjou	spouse	Henry_VI_of_England
Richard_of_Shrewsbury_Duke_of_York	type	Person
Richard_Count_of__tampes	parent	Joan_of_Navarre_Queen_of_England
Maria_Teresa_Felicitas_d_Este	child	Vincent_de_Bourbon_Count_of_Guingamp
Ferdinand_I_Holy_Roman_Emperor	child	Archduchess_Helena_of_Austria_1543_1574
Edward_IV_of_England	predecessor	Henry_VI_of_England
Vladislaus_II_of_Hungary	type	Person
Camilla_Martelli	spouse	Cosimo_I_de_Medici_Grand_Duke_of_Tuscany
Lucrezia_Tornabuoni	spouse	Piero_di_Cosimo_de_Medici
Eleanor_of_England_Queen_of_Castile	gender	female
Ingeborg_of_Kiev	type	Person
Philip_III_of_France	child	Philip_IV_of_France
Emanuel_Filibert_of_Savoy	type	Person
Baldwin_II_Count_of_Hainaut	parent	Richilde_Countess_of_Hainaut
Nicolas_Duke_of_Merc_ur	parent	Ren_e_of_Bourbon
Peter_of_Castile_Lord_of_Cameros	type	Person
Peter_of_Castile_Lord_of_Ledesma	type	Person
Margaret_of_Valois_Angoul_me	parent	Louise_of_Savoy
John_King_of_England	predecessor	Richard_I_of_England
Philippe_II_Duke_of_Orl_ans	mother	Elizabeth_Charlotte_Madame_Palatine
Albert_II_Duke_of_Austria	child	Frederick_III_Duke_of_Austria
Garsenda_Countess_of_Forcalquier	type	Person
Henry_III_Duke_of_Brabant	mother	Sophie_of_Thuringia_Duchess_of_Brabant
Ferdinand_Karl_Archduke_of_Austria_Este	hasSpouse	Yes
Fulk_King_of_Jerusalem	spouse	Ermengarde_Countess_of_Maine
Ferdinand_II_of_Aragon	successor	Joanna_of_Castile
Philip_VI_of_France	parent	Charles_Count_of_Valois
Hugh_the_Great	mother	Beatrice_of_Vermandois
Elisabeth_Farnese	type	Person
Henry_II_of_France	child	Claude_of_France_1547_1575
Maud_Chaworth	father	Patrick_de_Chaworth_Lord_of_Kidwelly
Alfonso_II_of_Aragon	spouse	Sancha_of_Castile_Queen_of_Aragon
Salomea_of_Berg	hasSpouse	Yes
Ferdinand_III_of_Castile	predecessor	Alfonso_IX_of_Le_n
Henry_II_of_France	parent	Francis_I_of_France
Yolande_of_Dreux_Duchess_of_Burgundy	parent	Robert_III_Count_of_Dreux
Bertha_of_Holland	parent	Gertrude_of_Saxony
Maria_Luisa_of_Spain	child	Archduke_Rainer_Joseph_of_Austria
Antoine_Duke_of_Montpensier	parent	Louis_Philippe_I_Duke_of_Orl_ans
Heilika_of_Lengenfeld	spouse	Otto_IV_Count_of_Scheyern
Maria_of_Austria_Holy_Roman_Empress	father	Charles_V_Holy_Roman_Emperor
Marie_of_Brabant_Queen_of_France	spouse	Philip_III_of_France
Edward_II_of_England	child	John_of_Eltham_Earl_of_Cornwall
Otto_William_Count_of_Burgundy	hasSpouse	No
Maria_Luisa_of_Parma	hasSpouse	Yes
Bonne_of_Luxembourg	child	Isabella_Countess_of_Vertus
Afonso_III_of_Portugal	child	Blanche_of_Portugal_1259_1321
John_II_of_France	child	John_Duke_of_Berry
Stephen_III_of_Auxonne	parent	Stephen_II_of_Auxonne
Agnes_of_Burgundy_Duchess_of_Aquitaine	hasSpouse	Yes
Henry_III_of_Castile	predecessor	John_I_of_Castile
Victor_Amadeus_II_of_Sardinia	mother	Fran_oise_Madeleine_d_Orl_ans
Pepin_the_Short	spouse	Bertrada_of_Laon
Hugh_Count_of_Burgundy	parent	Hugh_III_Duke_of_Burgundy
Charles_X	mother	Maria_Teresa_Rafaela_of_Spain
Berthold_II_Count_of_Andechs	hasSpouse	Yes
Adelaide_of_Holland	hasSpouse	Yes
Lorenzo_the_Elder	name	Lorenzo_the_Elder
Pepin_I_of_Aquitaine	type	Person
Otto_I_Duke_of_Saxony	successor	Henry_the_Fowler
Canute_VI_of_Denmark	predecessor	Valdemar_I_of_Denmark
Maria_Anna_of_Bavaria_born_1551	parent	Albert_V_Duke_of_Bavaria
Robert_III_Count_of_Dreux	predecessor	Robert_II_Count_of_Dreux
Maredudd_ap_Tudur	hasSpouse	No
Stephen_II_Duke_of_Bavaria	spouse	Elisabeth_of_Sicily_Duchess_of_Bavaria
Odo_of_France	mother	Robert_the_Strong
Louis_Duke_of_Savoy	parent	Amadeus_VIII_Duke_of_Savoy
Nicolas_Duke_of_Merc_ur	mother	Ren_e_of_Bourbon
Louis_of_Toulouse	type	Person
Anne_of_Foix_Candale	mother	Catherine_of_Foix_Countess_of_Candale
Louis_II_of_Anjou	name	Louis_II
Begga	hasSpouse	Yes
Joan_Countess_of_Ponthieu	type	Person
Edward_of_Westminster_Prince_of_Wales	type	Person
Charles_Count_of_Valois	child	Joan_of_Valois_Countess_of_Hainaut
Eleanor_of_Aragon_Queen_of_Portugal	father	Ferdinand_I_of_Aragon
John_II_of_Portugal	name	John_II
Hugh_II_Duke_of_Burgundy	mother	Sibylla_of_Burgundy_Duchess_of_Burgundy
Elisabeth_of_France_1602_1644	parent	Henry_IV_of_France
Maria_Beatrice_d_Este_Duchess_of_Massa	parent	Maria_Teresa_Cybo_Malaspina_Duchess_of_Massa
Carloman_son_of_Charles_the_Bald	type	Person
Marie__milie_de_Joly_de_Choin	spouse	Louis_Dauphin_of_France_son_of_Louis_XIV
John_I_of_Castile	father	Henry_II_of_Castile
Joan_III_Countess_of_Burgundy	mother	Joan_II_Countess_of_Burgundy
Prince_Philippe_Count_of_Paris	gender	male
Borrell_II_Count_of_Barcelona	hasSpouse	Yes
Henry_VI_of_England	predecessor	Henry_V_of_England
Henry_III_Duke_of_Brabant	parent	Henry_II_Duke_of_Brabant
Louise_de_Maisonblanche	type	Person
Isabella_of_France	child	John_of_Eltham_Earl_of_Cornwall
Theobald_II_of_Navarre	parent	Theobald_I_of_Navarre
Peter_I_Duke_of_Brittany	gender	male
Francis_II_Duke_of_Brittany	father	Richard_Count_of__tampes
Ragenfrid	successor	Charles_Martel
Peter_I_Duke_of_Brittany	child	Yolande_of_Brittany
Mahaut_of_Ch_tillon	father	Guy_IV_Count_of_Saint_Pol
Baldwin_II_Margrave_of_Flanders	gender	male
Mary_de_Bohun	spouse	Henry_IV_of_England
Henry_VII_Holy_Roman_Emperor	mother	Beatrice_of_Avesnes
Ernest_Duke_of_Austria	parent	Viridis_Visconti
Charles_de_Bourbon_cardinal	type	Person
Antoine_of_Navarre	spouse	Jeanne_d_Albret
Ren__of_Anjou	parent	Violant_of_Bar
Marie_of_Anjou	child	Joan_of_France_Duchess_of_Bourbon
Philip_II_Duke_of_Savoy	child	Philip_Duke_of_Nemours
Louis_III_of_France	parent	Ansgarde_of_Burgundy
Philippe_Charles_Duke_of_Anjou	type	Person
Louis_XVI	spouse	Marie_Antoinette
Marie_of_Anjou	type	Person
Empress_Jos_phine	child	Hortense_de_Beauharnais
William_IX_Duke_of_Aquitaine	hasSpouse	Yes
Henry_the_Middle_Duke_of_Brunswic_L_neburg	type	Person
Eleanor_of_England_Queen_of_Castile	child	Eleanor_of_Castile_died_1244
Stephen_II_Duke_of_Bavaria	hasSpouse	Yes
William_IX_Duke_of_Aquitaine	gender	male
Hedwig_of_Saxony	parent	Matilda_of_Ringelheim
Elias_II_Count_of_Maine	type	Person
Anne_of_Cyprus	parent	Charlotte_of_Bourbon_Queen_of_Cyprus
Hugh_Capet	mother	Eadhild
Archduchess_Anna_of_Austria	predecessor	Marie_of_Bade_Sponheim
John_I_of_Castile	parent	Juana_Manuel
Charles_Martel	gender	male
Isabella_de_Beauchamp	hasSpouse	Yes
William_of_Winchester_Lord_of_Lunenburg	mother	Matilda_of_England_Duchess_of_Saxony
Charibert_of_Laon	type	Person
Louis_Duke_of_Savoy	name	Louis
Matilda_of_T_bingen	hasSpouse	Yes
Albert_II_Duke_of_Austria	predecessor	Frederick_the_Fair
Isabella_Countess_of_Gloucester	spouse	John_King_of_England
William_Duke_of_J_lich_Cleves_Berg	hasSpouse	Yes
Joan_of__vreux	gender	female
Louis_Philippe_I	hasSpouse	Yes
Welf_father_of_Judith	spouse	Hedwig_of_Bavaria
Odo_IV_Duke_of_Burgundy	spouse	Joan_III_Countess_of_Burgundy
Charles_VI_of_France	successor	Charles_VII_of_France
Reginar_III_Count_of_Hainaut	type	Person
Otto_V_Margrave_of_Brandenburg_Salzwedel	type	Person
Adela_of_Normandy	spouse	Stephen_Count_of_Blois
Ferdinand_III_Grand_Duke_of_Tuscany	type	Person
Maria_Teresa_Felicitas_d_Este	gender	female
Louise_of_Lorraine	name	Louise_of_Lorraine
Bernard_of_Italy	predecessor	Charlemagne
Helie_of_Semur	hasSpouse	Yes
Eugene_Jean_Count_of_Soissons	type	Person
Alix_Duchess_of_Brittany	spouse	Peter_I_Duke_of_Brittany
Jeanne_d_Albret	spouse	Antoine_of_Navarre
Margaret_of_Valois	name	Margaret_of_Valois
Catherine_of_Hungary_Queen_of_Serbia	type	Person
Maximilian_II_Holy_Roman_Emperor	mother	Anne_of_Bohemia_and_Hungary
Eleanor_of_Navarre	child	Margaret_of_Foix
Philip_of_Castile_Lord_of_Cabrera_and_Ribera	type	Person
Adelaide_of_Italy	child	Emma_of_Italy
Henry_II_of_Navarre	successor	Jeanne_d_Albret
Richeza_of_Poland_Queen_of_Sweden	child	Sophia_of_Minsk
Louis_Bonaparte	successor	Napol_on_Louis_Bonaparte
Maria_of_Austria_Holy_Roman_Empress	gender	female
Matilda_of_Boulogne_Duchess_of_Brabant	spouse	Henry_I_Duke_of_Brabant
Mary_of_Burgundy_Duchess_of_Cleves	predecessor	Charles_the_Bold
Prince_George_William_of_Great_Britain	type	Person
Sophia_of_Hanover	hasSpouse	Yes
Maria_Cristina_of_Savoy	type	Person
Louis_XII	father	Charles_Duke_of_Orl_ans
Yaroslav_the_Wise	parent	Ingegerd_Olofsdotter_of_Sweden
Otto_V_Margrave_of_Brandenburg_Salzwedel	hasSpouse	Yes
Afonso_V_of_Portugal	successor	John_II_of_Portugal
Carlo_Buonaparte	father	Giuseppe_Maria_Buonaparte
Louis_VI_of_France	father	Philip_I_of_France
Marie_Hedwig_of_Hesse_Darmstadt	type	Person
Charles_II_of_Spain	successor	Philip_V_of_Spain
Eadred	type	Person
Charles_III_of_Spain	type	Person
Margaret_of_Valois_Angoul_me	mother	Louise_of_Savoy
Odo_of_France	mother	Adelaide_of_Tours
Juana_Enr_quez	spouse	John_II_of_Aragon
Louis_I_Duke_of_Bourbon	child	James_I_Count_of_La_Marche
William_II_Duke_of_Bavaria	type	Person
Blanche_of_Navarre_Duchess_of_Brittany	spouse	John_I_Duke_of_Brittany
Magnus_II_Duke_of_Brunswic_L_neburg	gender	male
Henry_son_of_Robert_I_of_Burgundy	mother	Helie_of_Semur
Francis_II_Duke_of_Brittany	spouse	Margaret_of_Brittany
John_King_of_England	father	Louis_VII_of_France
Clementia_of_Burgundy	type	Person
Cosimo_I_de_Medici_Grand_Duke_of_Tuscany	child	Francesco_I_de_Medici_Grand_Duke_of_Tuscany
Henry_III_of_Castile	parent	John_I_of_Castile
Agnes_of_Rochlitz	name	Agnes_of_Rochlitz
Joan_of_France_Duchess_of_Brittany	type	Person
Eleanor_of_Castile	child	Joan_of_Acre
Karl_August_Grand_Duke_of_Saxe_Weimar_Eisenach	hasSpouse	Yes
Sviatoslav_I	gender	male
Archduchess_Anna_of_Austria	child	William_V_Duke_of_Bavaria
Countess_Caroline_of_Nassau_Saarbr_cken	type	Person
Louis_II_d_Orl_ans_Duke_of_Longueville	spouse	Mary_of_Guise
Charles_the_Fat	father	Louis_the_German
Henry_son_of_Robert_I_of_Burgundy	mother	Ermengarde_of_Anjou_Duchess_of_Burgundy
Peter_II_of_Courtenay	hasSpouse	Yes
Otto_I_Duke_of_Bavaria	mother	Heilika_of_Lengenfeld
Philippe_I_Duke_of_Orl_ans	hasSpouse	Yes
Robert_I_of_France	name	Robert_I
Hugh_IV_Duke_of_Burgundy	parent	Odo_III_Duke_of_Burgundy
Piero_di_Cosimo_de_Medici	predecessor	Cosimo_de_Medici
John_Count_of_Angoul_me	hasSpouse	No
Ramon_Berenguer_IV_Count_of_Provence	father	Garsenda_Countess_of_Forcalquier
Peter_I_Count_of_Saint_Pol	hasSpouse	Yes
Otto_I_Duke_of_Saxony	gender	male
Violant_of_Bar	hasSpouse	Yes
Giovanni_di_Bicci_de_Medici	hasSpouse	No
Margaret_of_Provence	mother	Beatrice_of_Savoy
Louis_I_Duke_of_Orl_ans	child	Jean_de_Dunois
Elizabeth_Mure	type	Person
Isabella_of_Valois_Duchess_of_Bourbon	father	Charles_Count_of_Valois
Marie_Eleonore_of_Cleves	parent	Maria_of_Austria_Duchess_of_J_lich_Cleves_Berg
Princess_Amalie_of_Hesse_Darmstadt	type	Person
Otto_IV_Count_of_Burgundy	parent	Adelaide_Countess_of_Burgundy
Philip_the_Good	type	Person
Maria_Theresa_of_Naples_and_Sicily	child	Maria_Leopoldina_of_Austria
Marie_of_Anjou	spouse	Charles_VII_of_France
Sancha_of_Aragon_Countess_of_Toulouse	type	Person
Philip_I_of_Castile	child	Eleanor_of_Austria
Isabella_of_Valois_Duchess_of_Bourbon	parent	Margaret_Countess_of_Anjou
Adelaide_of_Tours	gender	female
Eadgifu_of_Wessex	type	Person
Archduchess_Eleanor_of_Austria_1582_1620	type	Person
Charles_V_of_France	mother	Joan_I_Countess_of_Auvergne
Philip_the_Bold	gender	male
Arthur_II_Duke_of_Brittany	child	John_of_Montfort
Maria_Antonia_Ferdinanda_of_Spain	child	Prince_Maurizio_Duke_of_Montferrat
Louis_VIII_of_France	child	Isabelle_of_France_saint
Philip_V_of_Spain	successor	Louis_I_of_Spain
Francis_II_Holy_Roman_Emperor	father	Leopold_II_Holy_Roman_Emperor
Anna_Eleonore_of_Hesse_Darmstadt	hasSpouse	Yes
Leopold_III_Duke_of_Austria	parent	Albert_II_Duke_of_Austria
Edward_II_of_England	spouse	Isabella_of_France
Infante_Philip_Duke_of_Calabria	type	Person
James_I_of_Aragon	parent	Peter_II_of_Aragon
Charles_Duke_of_Orl_ans	predecessor	Louis_I_Duke_of_Orl_ans
Margaret_of_Bavaria	spouse	John_the_Fearless
Archduchess_Maria_Clementina_of_Austria	parent	Leopold_II_Holy_Roman_Emperor
Jacquetta_of_Luxembourg	type	Person
Robert_I_of_France	mother	Robert_the_Strong
Charles_Emmanuel_I_Duke_of_Savoy	spouse	Catalina_Micaela_of_Spain
John_IV_Duke_of_Brittany	spouse	Mary_of_Waltham
Philippe_I_Duke_of_Orl_ans	spouse	Elizabeth_Charlotte_Madame_Palatine
James_IV_of_Scotland	hasSpouse	Yes
Cymburgis_of_Masovia	hasSpouse	Yes
Joan_I_of_Navarre	hasSpouse	Yes
Eleanor_of_Castile	child	Elizabeth_of_Rhuddlan
Charles_Frederick_Grand_Duke_of_Saxe_Weimar_Eisenach	type	Person
Isabella_Duchess_of_Lorraine	parent	Margaret_of_the_Palatinate
James_II_of_Scotland	type	Person
Charles_the_Simple	gender	male
Ernest_Augustus_Elector_of_Hanover	child	Maximilian_William_of_Brunswic_L_neburg
Gilbert_Duke_of_Lorraine	type	Person
Maria_Christina_of_the_Two_Sicilies	child	Mar_a_Cristina_Mu_oz_y_Borb_n_Marquise_of_la_Isabela
William_X_Duke_of_Aquitaine	mother	Philippa_Countess_of_Toulouse
Isabel_of_Coimbra	hasSpouse	Yes
Margaret_of_Bavaria	child	Philip_the_Good
Louis_Philippe_I	spouse	Maria_Amalia_of_Naples_and_Sicily
Hugh_V_Duke_of_Burgundy	predecessor	Robert_II_Duke_of_Burgundy
Valdemar_I_of_Denmark	spouse	Sophia_of_Minsk
Princess_Augusta_Sophia_of_the_United_Kingdom	type	Person
Ingegerd_Olofsdotter_of_Sweden	child	Elisiv_of_Kiev
Leopold_II_Holy_Roman_Emperor	child	Archduke_Louis_of_Austria
Philip_III_of_Navarre	mother	Margaret_of_Artois
Anna_of_Lorraine	type	Person
Arthur_III_Duke_of_Brittany	type	Person
Jacquetta_of_Luxembourg	child	Catherine_Woodville_Duchess_of_Buckingham
Anne_Gonzaga	type	Person
Henry_I_of_Navarre	mother	Agnes_of_Beaujeu
Afonso_I_of_Portugal	mother	Theresa_Countess_of_Portugal
Philip_I_of_Castile	father	Maximilian_I_Holy_Roman_Emperor
Anne_Gonzaga	hasSpouse	No
Berthold_Duke_of_Merania	hasSpouse	No
Anne_of_Kiev	father	Yaroslav_the_Wise
Victor_Amadeus_II_of_Sardinia	hasSpouse	Yes
Francis_II_Holy_Roman_Emperor	marriedTo	Maria_Theresa_of_Naples_and_Sicily
Judith_of_Flanders	type	Person
Maria_Luisa_of_Spain	gender	female
Judith_of_Bavaria_died_843	parent	Welf_father_of_Judith
Henry_II_of_Navarre	spouse	Margaret_of_Valois_Angoul_me
Mary_of_Hungary_Queen_of_Naples	hasSpouse	Yes
Archduke_Franz_Karl_of_Austria	type	Person
Marie_Eleonore_of_Cleves	mother	Jeanne_d_Albret
Frederick_III_Holy_Roman_Emperor	parent	Ernest_Duke_of_Austria
Margaret_of_Flanders_Duchess_of_Brabant	parent	Guy_Count_of_Flanders
Eadgifu_of_Wessex	parent	Edward_the_Elder
George_III	child	Prince_Edward_Duke_of_Kent_and_Strathearn
Louis_XIV	child	Louis_C_sar_Count_of_Vexin
Hedwig_of_Saxony	child	Hugh_Capet
Louise__lisabeth_of_France	type	Person
John_VIII_Count_of_Vend_me	predecessor	Louis_Count_of_Vend_me
Simon_Count_of_Ponthieu	type	Person
Agnes_of_France_Duchess_of_Burgundy	child	Louis_of_Burgundy
Charles_III_of_Spain	mother	Elisabeth_Farnese
Anne_Gonzaga	child	Luise_Marie_of_the_Palatinate
Baldwin_V_Count_of_Flanders	child	Matilda_of_Flanders
Frederick_Louis_Hereditary_Grand_Duke_of_Mecklenburg_Schwerin	spouse	Princess_Caroline_Louise_of_Saxe_Weimar_Eisenach
Philippe_I_Duke_of_Orl_ans	type	Person
Maria_Theresa	child	Archduke_Maximilian_Francis_of_Austria
Humbert_II_Count_of_Savoy	hasSpouse	No
Princess_Maria_Isabella_of_Naples_and_Sicily	type	Person
Henry_VI_Count_of_Luxembourg	gender	male
Alexander_Jagiellon	type	Person
Gertrude_of_Hohenberg	hasSpouse	Yes
John_I_of_Castile	name	John_I
Floris_I_Count_of_Holland	hasSpouse	Yes
Henry_III_of_England	successor	Edward_I_of_England
Archduchess_Barbara_of_Austria	type	Person
Napoleon_II	mother	Marie_Louise_Duchess_of_Parma
Elizabeth_Woodville	child	Edward_V_of_England
Ferdinand_II_of_Aragon	predecessor	Louis_XII
George_Duke_of_Brunswic_Calenberg	type	Person
Frederick_III_Duke_of_Lorraine	gender	male
Catherine_of_Foix_Countess_of_Candale	gender	female
Mary_de_Bohun	type	Person
John_III_Duke_of_Brittany	parent	Arthur_II_Duke_of_Brittany
Matilda_of_France	child	Gerberga_of_Burgundy
Maria_Antonia_Ferdinanda_of_Spain	mother	Maria_Amalia_of_Saxony
Valdemar_I_of_Denmark	predecessor	Sweyn_III_of_Denmark
Louis_V_of_France	parent	Lothair_of_France
Victor_Amadeus_III_of_Sardinia	child	Maria_Anna_of_Savoy_Duchess_of_Chablais
Joanna_of_Flanders	spouse	John_of_Montfort
Yolande_Duchess_of_Lorraine	spouse	Frederick_II_Count_of_Vaud_mont
James_Duke_of_Rothesay_born_1540	type	Person
Henry_Stuart_Lord_Darnley	hasSpouse	Yes
Mary_Tudor_Queen_of_France	father	Henry_VII_of_England
Fulk_I_Count_of_Anjou	type	Person
Hedwig_of_Bavaria	spouse	Welf_father_of_Judith
Maria_Teresa_of_Savoy_1803_1879	type	Person
Lambert_II_Count_of_Louvain	hasSpouse	No
Humbert_II_Count_of_Savoy	gender	male
Denis_of_Portugal	parent	Beatrice_of_Castile_1242_1303
Maria_Teresa_Felicitas_d_Este	mother	Charlotte_Agla__d_Orl_ans
Landgravine_Elisabeth_Amalie_of_Hesse_Darmstadt	child	Maria_Sophia_of_Neuburg
Robert_Count_of_Clermont	spouse	Beatrice_of_Burgundy_Lady_of_Bourbon
Arnulf_II_Count_of_Flanders	hasSpouse	Yes
Anne_of_Brittany	gender	female
Charles_the_Bold	father	Philip_the_Good
Guillaume_de_Montfort_of_Hainaut	successor	Amaury_I_de_Montfort
Countess_Palatine_Dorothea_Sophie_of_Neuburg	hasSpouse	Yes
William_the_Younger_Duke_of_Brunswic_L_neburg	successor	Ernest_II_Duke_of_Brunswic_L_neburg
Baldwin_IV_Count_of_Flanders	spouse	Ogive_of_Luxembourg
Saint_Margaret_of_Scotland	parent	Edward_the_Exile
Ramon_Borrell_Count_of_Barcelona	spouse	Ermesinde_of_Carcassonne
Edward_III_of_England	parent	Isabella_of_France
Catherine_I_Latin_Empress	type	Person
Marie_de_Medici	hasSpouse	Yes
Blanche_of_Castile	mother	Eleanor_of_England_Queen_of_Castile
Maria_Beatrice_d_Este_Duchess_of_Massa	father	Ercole_III_d_Este_Duke_of_Modena
Adelaide_of_Auxerre_born_c._870	father	Robert_III_of_Worms
Francesco_I_de_Medici_Grand_Duke_of_Tuscany	predecessor	Cosimo_I_de_Medici_Grand_Duke_of_Tuscany
Beatrice_Regina_della_Scala	hasSpouse	Yes
Isabella_of_Burgundy_Queen_of_Germany	spouse	Rudolf_I_of_Germany
Anne_Queen_of_Great_Britain	type	Person
J_r_me_Bonaparte	type	Person
Isabella_of_Portugal_Queen_of_Castile	gender	female
Marie_Caroline_of_Bourbo_Two_Sicilies_Duchess_of_Berry	mother	Archduchess_Maria_Clementina_of_Austria
John_Stewart_of_Darnley	type	Person
Catherine_of_Valois	father	Charles_VI_of_France
Theodoric_II_Duke_of_Lorraine	gender	male
James_V_of_Scotland	gender	female
Robert_II_Count_of_Dreux	child	Philippa_of_Dreux
Louis_X_of_France	predecessor	Joan_I_of_Navarre
Benedicta_Henrietta_of_the_Palatinate	gender	female
Louis_Philippe_I	successor	Ferdinand_Philippe_Duke_of_Orl_ans
Charles_III_of_Spain	name	Charles_III
Louis_Antoine_Duke_of_Angoul_me	parent	Charles_X
Adelaide_of_Maurienne	name	Adelaide_of_Maurienne
A_nor_de_Ch_tellerault	type	Person
Mar_a_Isabella_of_Spain	hasSpouse	Yes
John_II_of_Aragon	mother	Eleanor_of_Alburquerque
Charles_the_Simple	parent	Ansgarde_of_Burgundy
Louis_VI_of_France	child	Peter_I_of_Courtenay
Maria_Antonia_Ferdinanda_of_Spain	child	Maria_Anna_of_Savoy_Duchess_of_Chablais
Henry_II_Duke_of_Brabant	gender	male
Louis_XVIII	gender	male
Victor_Amadeus_I_Duke_of_Savoy	parent	Charles_Emmanuel_I_Duke_of_Savoy
Maria_Theresa_of_Spain	mother	Mariana_of_Austria
Louise_of_Savoy	parent	Margaret_of_Bourbon_1438_1483
Ferdinand_III_of_Castile	successor	Alfonso_X_of_Castile
Eleanor_of_Castile	gender	female
Philip_II_of_Spain	spouse	Maria_Manuela_Princess_of_Portugal
Anabella_Drummond	spouse	Robert_III_of_Scotland
Fran_oise_d_Aubign__Marquise_de_Maintenon	gender	female
Sophia_Eleonore_of_Saxony	parent	John_George_I_Elector_of_Saxony
Maria_Ludovika_of_Austria_Este	type	Person
Philip_VI_of_France	mother	Mahaut_of_Ch_tillon
Alfonso_X_of_Castile	parent	Elisabeth_of_Swabia
Salomea_of_Berg	parent	Henry_I_Count_of_Berg
John_Constable_of_Portugal	hasSpouse	Yes
Louis_Dauphin_of_France_son_of_Louis_XIV	mother	Fran_oise_Ath_na_s_de_Rochechouart_Marquise_de_Montespan
Ren__II_Duke_of_Lorraine	father	Frederick_II_Count_of_Vaud_mont
Yaroslav_the_Wise	spouse	Ingegerd_Olofsdotter_of_Sweden
Oberto_I	hasSpouse	No
Alfonso_X_of_Castile	child	Fernando_de_la_Cerda_1255_1275
Garsenda_Countess_of_Forcalquier	successor	Ramon_Berenguer_IV_Count_of_Provence
Philip_III_of_Spain	predecessor	Philip_II_of_Spain
George_I_of_Great_Britain	father	Ernest_Augustus_Elector_of_Hanover
Maria_of_Portugal_Marchioness_of_Tortosa	type	Person
Blanche_of_Navarre_Queen_of_France	gender	female
Joan_of_France_Duchess_of_Berry	type	Person
Lucien_Bonaparte	type	Person
Maud_of_Apulia	type	Person
Adam_FitzRoy	type	Person
Hermann_Billung	hasSpouse	Yes
Frederick_III_Duke_of_Austria	type	Person
Richard_II_of_England	successor	Henry_IV_of_England
Robert_II_Count_of_Dreux	parent	Agnes_de_Baudemont_Countess_of_Braine
Princess_Mary_Duchess_of_Gloucester_and_Edinburgh	type	Person
Leonor_de_Alvim	hasSpouse	Yes
Louis_XIV	parent	Louis_XIII
Sancho_I_of_Portugal	successor	Afonso_II_of_Portugal
Charlotte_of_Bourbon_Queen_of_Cyprus	parent	Catherine_of_Vend_me
Odo_II_Count_of_Blois	gender	male
Caterina_Sforza	type	Person
Berthold_Duke_of_Merania	gender	male
Theobald_I_of_Navarre	successor	Theobald_II_of_Navarre
Isabella_of_Castile_Queen_of_Aragon	type	Person
Marguerite_of_Lorraine	type	Person
Charles_Duke_of_Berry_1686_1714	type	Person
Dirk_I_Count_of_Holland	hasSpouse	No
Maria_Theresa	child	Archduchess_Maria_Elisabeth_of_Austria_born_1737
Elisabeth_of_Nuremberg	parent	Frederick_V_Burgrave_of_Nuremberg
Magnus_I_Duke_of_Brunswic_L_neburg	hasSpouse	Yes
John_FitzAlan_1st_Baron_Arundel	type	Person
Blanche_of_Burgundy	hasSpouse	Yes
Constance_of_Arles	father	Louis_V_of_France
Madeleine_of_Valois	spouse	James_V_of_Scotland
Pepin_of_Herstal	successor	Theudoald
Judith_of_Habsburg	child	Margaret_of_Bohemia_Duchess_of_Wroclaw
Isabella_of_Valois_Duchess_of_Bourbon	child	Louis_II_Duke_of_Bourbon
Maria_Theresa_of_Austria_Este_Queen_of_Sardinia	gender	female
Ramon_Berenguer_II_Count_of_Barcelona	spouse	Maud_of_Apulia
George_III	hasSpouse	Yes
Charles_VIII_of_France	predecessor	Louis_XI
Charles_Duke_of_Vend_me	father	Francis_Count_of_Vend_me
Enno_III_Count_of_East_Frisia	hasSpouse	Yes
Anne_of_Bohemia_and_Hungary	spouse	Ferdinand_I_Holy_Roman_Emperor
Margaret_of_Bourbon_1438_1483	spouse	Philip_II_Duke_of_Savoy
Louis_XVII	parent	Louis_XVI
Beatrice_of_Bavaria	type	Person
Hedwig_of_Saxony	parent	Henry_the_Fowler
John_IV_Duke_of_Brittany	hasSpouse	Yes
Beatrice_of_Provence	predecessor	Ramon_Berenguer_IV_Count_of_Provence
Beatrice_of_England	child	John_of_Brittany_Earl_of_Richmond
John_I_Duke_of_Lorraine	father	Rudolph_Duke_of_Lorraine
Joanna_of_Castile	predecessor	Philip_I_of_Castile
Gaston_de_Foix_Count_of_Candale	spouse	Catherine_of_Foix_Countess_of_Candale
Urraca_of_Le_n	gender	male
Edward_King_of_Portugal	gender	male
Marie_of_Anjou	mother	Violant_of_Bar
Charles_II_Archduke_of_Austria	spouse	Maria_Anna_of_Bavaria_born_1551
Charlotte_of_Mecklenburg_Strelitz	child	Prince_Octavius_of_Great_Britain
Martin_of_Aragon	type	Person
Ferdinand_II_of_Aragon	child	Isabella_of_Aragon_Queen_of_Portugal
Rixa_of_Werle	hasSpouse	Yes
Louis_Philippe_II_Duke_of_Orl_ans	child	Louis_Philippe_I_Duke_of_Orl_ans
Anna_Maria_of_Mecklenburg_Schwerin	mother	Anna_Maria_of_Ostfriesland
Antoine_Duke_of_Montpensier	parent	Louis_Philippe_I
Fulk_King_of_Jerusalem	successor	Geoffrey_Plantagenet_Count_of_Anjou
Peter_I_of_Portugal	child	Ferdinand_I_of_Portugal
Anne_of_York_daughter_of_Edward_IV	type	Person
Charles_de_Morny_Duke_of_Morny	type	Person
Maria_Beatrice_of_Savoy	name	Maria_Beatrice_of_Savoy
Hugh_of_Italy	mother	Bertha_daughter_of_Lothair_II
Alys_of_France_Countess_of_Vexin	gender	female
Judith_of_Habsburg	gender	female
Elias_I_Count_of_Maine	hasSpouse	No
Mary_de_Bohun	gender	female
John_II_of_France	spouse	Joan_I_Countess_of_Auvergne
Eadhild	hasSpouse	Yes
Margaret_I_Countess_of_Flanders	parent	Thierry_Count_of_Flanders
Anne_of_Cyprus	type	Person
John_I_Count_of_Hainaut	mother	Bouchard_IV_of_Avesnes
Alfonso_IX_of_Le_n	mother	Urraca_L_pez_de_Haro
Eleanor_of_Aragon_Queen_of_Portugal	type	Person
Henry_I_of_Navarre	predecessor	Theobald_II_of_Navarre
Ferdinand_Philippe_Duke_of_Orl_ans	parent	Maria_Amalia_of_Naples_and_Sicily
Rudolph_Duke_of_Lorraine	spouse	Marie_de_Ch_tillon_1323_1363
Duke_George_Augustus_of_Mecklenburg	type	Person
Alfonso_VII_of_Le_n_and_Castile	spouse	Berengaria_of_Barcelona
Matilda_of_Frisia	spouse	Henry_I_of_France
Louise_of_France_1737_1787	type	Person
Countess_Palatine_Caroline_of_Zweibr_cken	child	Princess_Amalie_of_Hesse_Darmstadt
Carloman_II	hasSpouse	No
Elizabeth_of_Lancaster_Duchess_of_Exeter	type	Person
Prince_Frederick_of_Great_Britain	type	Person
Elizabeth_the_Cuman	gender	female
Ren__II_Duke_of_Lorraine	child	Jean_Cardinal_of_Lorraine
Vladislaus_II_of_Hungary	hasSpouse	Yes
Ferdinand_I_of_Portugal	parent	Peter_I_of_Portugal
Philip_V_of_Spain	hasSpouse	Yes
Maria_Theresa_of_Spain	spouse	Louis_XIV
Philip_I_of_France	spouse	Bertrade_of_Montfort
Albert_Frederick_Duke_of_Prussia	hasSpouse	Yes
Baldwin_III_Count_of_Hainaut	hasSpouse	Yes
Louis_I_Duke_of_Orl_ans	child	Margaret_Countess_of_Vertus
James_Stewart_5th_High_Steward_of_Scotland	gender	male
Beatrice_of_Brandenburg	parent	Otto_V_Margrave_of_Brandenburg_Salzwedel
James_III_of_Scotland	type	Person
Johann_Wilhelm_Elector_Palatine	type	Person
Francis_I_of_France	successor	Henry_II_of_France
Rudolph_of_France	mother	Adelaide_of_Auxerre_born_c._870
Dirk_II_Count_of_Holland	successor	Arnulf_Count_of_Holland
Ferdinand_Duke_of_Viseu	child	Jo_o_Duke_of_Viseu
Margaret_of_Artois	child	Philip_III_of_Navarre
John_I_of_Aragon	hasSpouse	Yes
Henry_I_of_Navarre	name	Henry_I
Margaret_of_Bavaria	mother	Margaret_of_Brieg
Emma_of_Italy	type	Person
Ermengarde_Countess_of_Maine	hasSpouse	Yes
Hugh_IV_Duke_of_Burgundy	child	Odo_Count_of_Nevers
Philip_III_of_Spain	mother	Mary_I_of_England
Catherine_of_Lorraine_1573_1648	type	Person
Beatrice_of_Brandenburg	type	Person
Afonso_III_of_Portugal	predecessor	Sancho_II_of_Portugal
Eleanor_of_Aragon_Queen_of_Portugal	parent	Ferdinand_I_of_Aragon
Madame_Ad_la_de	type	Person
Eleanor_of_Alburquerque	name	Eleanor_of_Alburquerque
Margaret_of_Valois_Duchess_of_Berry	spouse	Emmanuel_Philibert_Duke_of_Savoy
Mahaut_Countess_of_Artois	gender	female
Benedicta_Henrietta_of_the_Palatinate	type	Person
Francis_I_Duke_of_Lorraine	successor	Charles_III_Duke_of_Lorraine
Philip_IV_of_France	predecessor	Joan_I_of_Navarre
Baldwin_III_Count_of_Hainaut	parent	Baldwin_II_Count_of_Hainaut
Anne_of_Brittany	gender	male
Poppa_of_Bayeux	parent	Berengar_II_of_Neustria
Pepin_I_of_Aquitaine	parent	Louis_the_Pious
Louis_Dauphin_of_France_son_of_Louis_XIV	mother	Maria_Theresa_of_Spain
Mary_of_Guise	child	Mary_Queen_of_Scots
Francis_IV_Duke_of_Modena	spouse	Maria_Beatrice_of_Savoy
Ferdinand_IV_of_Castile	predecessor	Sancho_IV_of_Castile
Owen_Tudor	gender	male
Frederick_III_Duke_of_Lorraine	hasSpouse	Yes
Ernest_I_Duke_of_Brunswic_L_neburg	type	Person
Isabella_of_Hainault	type	Person
Adela_of_Normandy	type	Person
Anna_Maria_of_Mecklenburg_Schwerin	parent	Anna_Maria_of_Ostfriesland
Guy_IV_Count_of_Saint_Pol	spouse	Marie_of_Brittany_Countess_of_Saint_Pol
David_II_of_Scotland	successor	Robert_II_of_Scotland
Joan_of__vreux	parent	Margaret_of_Artois
Henry_II_of_England	spouse	Eleanor_of_Aquitaine
Arnulf_II_Count_of_Flanders	type	Person
Charlotte_of_Bourbon_Queen_of_Cyprus	spouse	Janus_of_Cyprus
Gaston_IV_Count_of_Foix	spouse	Eleanor_of_Navarre
Charles_Emmanuel_I_Duke_of_Savoy	parent	Emmanuel_Philibert_Duke_of_Savoy
Ranulf_II_of_Aquitaine	hasSpouse	No
Eleanor_of_England_Queen_of_Castile	child	Urraca_of_Castile_Queen_of_Portugal
Ingeborg_of_Kiev	hasSpouse	No
Philip_VI_of_France	parent	Mahaut_of_Ch_tillon
Charles_Martel_of_Anjou	type	Person
Rozala_of_Italy	mother	Willa_of_Tuscany
Claude_of_France	father	Maximilian_I_Holy_Roman_Emperor
Cristina_daughter_of_Edward_the_Exile	type	Person
Joan_II_Countess_of_Burgundy	father	Otto_IV_Count_of_Burgundy
Maria_Teresa_Felicitas_d_Este	type	Person
Mary_Queen_of_Scots	successor	James_VI_and_I
Adelaide_of_Burgundy_Duchess_of_Brabant	hasSpouse	Yes
John_IV_Duke_of_Brittany	mother	Joanna_of_Flanders
Ferdinand_I_of_Aragon	child	Henry_Duke_of_Villena
Ragenfrid	type	Person
Henry_X_Duke_of_Bavaria	hasSpouse	Yes
Charles_VIII_of_France	parent	Charlotte_of_Savoy
Otto_I_Duke_of_Brunswic_L_neburg	hasSpouse	No
Ernest_Duke_of_Austria	type	Person
Blanche_of_Brittany	parent	Beatrice_of_England
Arthur_II_Duke_of_Brittany	parent	Beatrice_of_England
Louis_I_of_Anjou	successor	Louis_II_of_Anjou
Adelaide_of_Auxerre_born_c._870	type	Person
Prince_Philippe_Count_of_Paris	parent	Duchess_Helene_of_Mecklenburg_Schwerin
Ferdinand_Karl_Archduke_of_Austria_Este	parent	Francis_I_Holy_Roman_Emperor
John_King_of_England	successor	Henry_III_of_England
Charles_III_of_Spain	mother	Maria_Luisa_Gabriella_of_Savoy
Jacquetta_of_Luxembourg	child	Edward_Woodville_Lord_Scales
Maria_Antonia_Ferdinanda_of_Spain	child	Princess_Maria_Carolina_of_Savoy
Isabella_of_Valois_Duchess_of_Bourbon	mother	Catherine_I_Latin_Empress
Maximilian_II_Holy_Roman_Emperor	parent	Anne_of_Bohemia_and_Hungary
Sancho_IV_of_Castile	spouse	Mar_a_de_Molina
Benedicta_Henrietta_of_the_Palatinate	parent	Anne_Gonzaga
Berengaria_of_Le_n	type	Person
Odo_I_Duke_of_Burgundy	hasSpouse	Yes
Yolanda_Latin_Empress	parent	Baldwin_V_Count_of_Hainaut
Prince_Ferdinand_Duke_of_Montpensier	type	Person
Robert_II_of_France	spouse	Bertha_of_Burgundy
Joan_I_of_Navarre	parent	Henry_I_of_Navarre
Theobald_II_Count_of_Champagne	gender	male
Eleanor_of_Castile	parent	Elisabeth_of_Swabia
Elizabeth_Woodville	father	Richard_Woodville_1st_Earl_Rivers
Princess_Elizabeth_of_the_United_Kingdom	type	Person
James_Hepburn_4th_Earl_of_Bothwell	gender	male
Amadeus_VIII_Duke_of_Savoy	hasSpouse	Yes
Blanche_of_Castile	parent	Alfonso_VIII_of_Castile
Charles_the_Bald	child	Lothair_the_Lame
Gaston_IV_Count_of_Foix	hasSpouse	Yes
Agatha_wife_of_Edward_the_Exile	type	Person
Gisela_of_Burgundy_Marchioness_of_Montferrat	parent	William_I_Count_of_Burgundy
Henry_IV_of_France	predecessor	Henry_III_of_France
Alfonso_II_of_Aragon	child	Eleanor_of_Aragon_Countess_of_Toulouse
Alfonso_VIII_of_Castile	spouse	Eleanor_of_England_Queen_of_Castile
Joan_Countess_of_Ponthieu	father	Simon_Count_of_Ponthieu
Francis_II_Holy_Roman_Emperor	child	Archduchess_Marie_Anne_of_Austria
Beatrice_Regina_della_Scala	spouse	Bernab__Visconti
Frederick_IV_Duke_of_Lorraine	parent	Theobald_II_Duke_of_Lorraine
Alfonso_XI_of_Castile	type	Person
Carloman_mayor_of_the_palace	successor	Pepin_the_Short
Afonso_V_of_Portugal	parent	Edward_King_of_Portugal
Philip_the_Bold	predecessor	John_II_of_France
Francis_Count_of_Vend_me	parent	John_VIII_Count_of_Vend_me
Louis_XVII	parent	Marie_Antoinette
Baldwin_III_Count_of_Hainaut	type	Person
Vladimir_the_Great	spouse	Rogneda_of_Polotsk
Yaroslav_the_Wise	name	Yaroslav_the_Wise
Henry_I_Count_of_Champagne	gender	male
Saint_Margaret_of_Scotland	type	Person
Edward_the_Elder	gender	male
Charles_Emmanuel_II_Duke_of_Savoy	gender	male
Sophia_Eleonore_of_Hesse_Darmstadt	type	Person
Ferdinand_IV_of_Castile	type	Person
Henry_IV_of_France	successor	Louis_XIII
Barbara_Jagiellon	parent	Casimir_IV_Jagiellon
Simon_I_de_Montfort	parent	Amaury_I_de_Montfort
Lambert_II_Count_of_Louvain	hasSpouse	Yes
Peter_I_Duke_of_Brittany	father	Robert_II_Count_of_Dreux
Elisabeth_of_France_1602_1644	mother	Marie_de_Medici
Marie_of_Cleves_Duchess_of_Orl_ans	spouse	Charles_Duke_of_Orl_ans
Constance_of_Castile	parent	Alfonso_VII_of_Le_n_and_Castile
Drogo_of_Champagne	predecessor	Pepin_of_Herstal
Henri_de_Lorraine_Chaligny	type	Person
Margaret_Holland_Duchess_of_Clarence	parent	Thomas_Holland_2nd_Earl_of_Kent
Pope	type	Person
Adelaide_of_Tours	name	Adelaide_of_Tours
Louis_IX_of_France	gender	male
Edward_the_Elder	hasSpouse	Yes
Baldwin_II_Margrave_of_Flanders	parent	Judith_of_Flanders
Alfonso_IX_of_Le_n	parent	Urraca_of_Portugal
Marie_de_Medici	type	Person
Girolamo_Savonarola	predecessor	Piero_the_Unfortunate
Louis_Philippe_II_Duke_of_Orl_ans	father	Louis_Philippe_I_Duke_of_Orl_ans
Welf_I_Duke_of_Bavaria	hasSpouse	Yes
Guy_IV_Count_of_Saint_Pol	hasSpouse	Yes
Albert_IV_Count_of_Habsburg	hasSpouse	Yes
Beatrice_of_Savoy	name	Beatrice_of_Savoy
Anna_Sophia_of_Prussia	hasSpouse	No
Alfonso_X_of_Castile	child	Violant_of_Castile
Philip_the_Good	spouse	Isabella_of_Portugal_Duchess_of_Burgundy
Princess_Antoinette_of_Brunswic_Wolfenb_ttel	type	Person
Philip_IV_of_Spain	mother	Margaret_of_Austria_Queen_of_Spain
Ferdinand_Karl_Archduke_of_Austria_Este	mother	Maria_Theresa
Louis_X_of_France	parent	Philip_IV_of_France
Ermentrude_of_Orl_ans	mother	Engeltrude_de_F_zensac
Margaret_of_Austria_Queen_of_Spain	child	Maria_Anna_of_Spain
James_I_of_Scotland	child	James_II_of_Scotland
Theobald_III_Count_of_Blois	spouse	Gersende_of_Maine
Afonso_I_of_Portugal	parent	Henry_Count_of_Portugal
Gerolf_of_Holland	type	Person
Francis_Duke_of_Anjou	mother	Catherine_de_Medici
Denis_of_Portugal	successor	Afonso_IV_of_Portugal
Francis_I_Duke_of_Lorraine	hasSpouse	Yes
Princess_Magdalena_Augusta_of_Anhalt_Zerbst	child	Princess_Augusta_of_Saxe_Gotha
Henry_VI_of_England	mother	Catherine_of_Valois
Gisela_of_Burgundy_Marchioness_of_Montferrat	gender	female
Arnulf_Count_of_Holland	hasSpouse	No
William_III_Duke_of_Aquitaine	gender	male
Eleanor_of_Lancaster	child	Joan_Fitzalan_Countess_of_Hereford
Philippa_of_Dreux	type	Person
Alfonso_V_of_Aragon	predecessor	Ferdinand_I_of_Aragon
Marie_of_France_Countess_of_Champagne	hasSpouse	Yes
Margaret_of_Joinville	type	Person
Eleanor_of_Portugal_Holy_Roman_Empress	mother	Eleanor_of_Aragon_Queen_of_Portugal
Charles_Martel	mother	Alpaida
Prince_Gennaro_of_Naples_and_Sicily	type	Person
Francis_I_Holy_Roman_Emperor	gender	female
Henry_III_of_Castile	type	Person
Begga	hasSpouse	No
Th_odrate_of_Troyes	spouse	Odo_of_France
Adelaide_of_Tours	spouse	Conrad_I_Count_of_Auxerre
Ferdinand_II_of_Aragon	mother	Juana_Enr_quez
March_of_Friuli	hasSpouse	Yes
William_III_of_M_con	hasSpouse	No
Margaret_Tudor	type	Person
Ernest_I_Duke_of_Brunswic_L_neburg	parent	Henry_the_Middle_Duke_of_Brunswic_L_neburg
Henry_I_of_Navarre	type	Person
Fran_ois_de_Lorraine	type	Person
Sviatoslav_I	successor	Vladimir_the_Great
Marie_Eleonore_of_Cleves	hasSpouse	Yes
Bartholomew_de_L_Isle_Bouchard	hasSpouse	No
Baldwin_V_Count_of_Flanders	hasSpouse	Yes
Afonso_I_Duke_of_Braganza	hasSpouse	Yes
Charles_Martel	child	Bernard_son_of_Charles_Martel
_thelwulf_King_of_Wessex	child	_thelberht_King_of_Wessex
Andrew_II_of_Hungary	type	Person
Richard_Fitzalan_3rd_Earl_of_Arundel	spouse	Eleanor_of_Lancaster
Eleanor_of_Aquitaine	child	Geoffrey_II_Duke_of_Brittany
Margaret_of_Brabant	name	Margaret_of_Brabant
Anna_Eleonore_of_Hesse_Darmstadt	spouse	George_Duke_of_Brunswic_Calenberg
Maximilian_III_Archduke_of_Austria	type	Person
Maud_of_Apulia	hasSpouse	Yes
Marie_of_Bade_Sponheim	successor	Archduchess_Anna_of_Austria
Charles_III_Duke_of_Savoy	type	Person
Robert_II_of_Scotland	name	Robert_II
Charles_X	successor	Louis_Philippe_I
Philip_I_of_Castile	gender	male
Peter_II_of_Aragon	father	Alfonso_II_of_Aragon
John_the_Fearless	child	Philip_the_Good
Philippe_I_Duke_of_Orl_ans	parent	Louis_XIII
Rudolph_II_of_Burgundy	parent	Rudolph_I_of_Burgundy
Violant_of_Bar	spouse	Louis_II_of_Anjou
Polyxena_of_Hesse_Rotenburg	type	Person
Maria_of_Aragon_Queen_of_Portugal	child	Ferdinand_of_Portugal_Duke_of_Guarda
Maria_Theresa_of_Austria_Este_Queen_of_Sardinia	mother	Maria_Beatrice_d_Este_Duchess_of_Massa
Henry_IV_of_Castile	successor	Isabella_I_of_Castile
Albert_V_Duke_of_Bavaria	spouse	Archduchess_Anna_of_Austria
Clemence_of_Austria	parent	Rudolf_I_of_Germany
Caroline_of_Ansbach	spouse	George_II_of_Great_Britain
Edward_III_of_England	predecessor	Edward_II_of_England
Maria_Beatrice_d_Este_Duchess_of_Massa	father	Eugene_Jean_Count_of_Soissons
Hugh_I_Duke_of_Burgundy	successor	Odo_I_Duke_of_Burgundy
Albert_Azzo_I_Margrave_of_Milan	hasSpouse	Yes
Louis_Duke_of_Orl_ans_1703_1752	predecessor	Henri_Jules_Prince_of_Cond_
Jeanne_d_Albret	gender	female
Anne_of_Brittany	spouse	Louis_XII
Henry_III_of_England	parent	John_King_of_England
Arnulf_Count_of_Holland	father	Dirk_II_Count_of_Holland
Margaret_of_Brabant	mother	Margaret_of_Flanders_Duchess_of_Brabant
John_II_Duke_of_Brittany	child	Blanche_of_Brittany
Hemma	hasSpouse	Yes
Empress_Jos_phine	gender	female
Louise_of_Lorraine	hasSpouse	Yes
Elisabeth_of_Austria_Queen_of_France	father	Maximilian_II_Holy_Roman_Emperor
Eleanor_of_Provence	child	Edward_I_of_England
Albert_III_Duke_of_Austria	type	Person
Victor_Amadeus_I_Duke_of_Savoy	child	Princess_Margaret_Yolande_of_Savoy
Alfonso_VII_of_Le_n_and_Castile	father	Raymond_of_Burgundy
Saint_Margaret_of_Scotland	child	Mary_of_Scotland_Countess_of_Boulogne
Adela_of_Milan	hasSpouse	Yes
Eleanor_of_Navarre	spouse	Gaston_IV_Count_of_Foix
Anne_of_Bohemia_and_Hungary	type	Person
Princess_Isabella_of_Parma	type	Person
Ecgberht_King_of_Wessex	predecessor	Baldred_of_Kent
Sophie_of_France_1786_1787	type	Person
Maria_Anna_of_Bavaria_born_1551	mother	Archduchess_Anna_of_Austria
John_King_of_England	mother	Eleanor_of_Aquitaine
Marie_Countess_of_Harcourt	spouse	Antoine_Count_of_Vaud_mont
Isabel_of_Barcelos	type	Person
Bonne_of_Luxembourg	child	Louis_I_of_Anjou
Edward_the_Elder	child	Eadgifu_of_Wessex
Lorenzo_de_Medici	predecessor	Piero_di_Cosimo_de_Medici
Teresa_Louren_o	type	Person
Salomea_of_Berg	name	Salomea_of_Berg
Elizabeth_of_York	parent	Elizabeth_Woodville
Philip_III_of_Navarre	spouse	Joan_II_of_Navarre
Margaret_of_Foix	name	Margaret_of_Foix
Blanche_of_Castile	father	Alfonso_VIII_of_Castile
George_III	child	George_IV
John_I_Count_of_Hainaut	spouse	Adelaide_of_Holland
Matthias_I_Duke_of_Lorraine	successor	Simon_II_Duke_of_Lorraine
George_IV	type	Person
Charles_Emmanuel_II_Duke_of_Savoy	father	Victor_Amadeus_I_Duke_of_Savoy
Anne_Gonzaga	hasSpouse	Yes
Maria_Theresa_of_Savoy	hasSpouse	Yes
Charles_Duke_of_Lower_Lorraine	type	Person
Maria_Carolina_of_Austria	child	Princess_Maria_Antonia_of_Naples_and_Sicily
Christine_of_Hesse	mother	Christine_of_Saxony
Francis_II_of_France	hasSpouse	Yes
Francis_II_Holy_Roman_Emperor	mother	Maria_Luisa_of_Spain
Bertrade_of_Montfort	gender	female
Alfonso_X_of_Castile	child	Beatrice_of_Castile_1242_1303
Salomea_of_Berg	gender	female
Cecily_of_York	type	Person
Sancho_Count_of_Provence	successor	Alfonso_II_Count_of_Provence
Louis_XVI	child	Louis_XVII
Anne_Marie_Th_r_se_de_Lorraine	type	Person
Gerold_of_Vinzgau	hasSpouse	Yes
Otto_II_Count_of_Chiny	spouse	Godfrey_I_Count_of_Louvain
Louis_XIV	child	Louis_Count_of_Vermandois
Ferdinand_Philippe_Duke_of_Orl_ans	type	Person
George_Gordon_4th_Earl_of_Huntly	child	James_Gordon_Jesuit
Francis_I_of_France	hasSpouse	Yes
Pope	hasSpouse	No
Mary_Queen_of_Scots	predecessor	James_V_of_Scotland
George_III	child	Prince_Augustus_Frederick_Duke_of_Sussex
Louis_II_of_Anjou	gender	male
Maximilian_I_Holy_Roman_Emperor	successor	Charles_V_Holy_Roman_Emperor
Nicholas_Francis_Duke_of_Lorraine	type	Person
Margaret_of_Burgundy_Queen_of_France	parent	Robert_II_Duke_of_Burgundy
Amicie_de_Courtenay	hasSpouse	Yes
Charles_VI_Holy_Roman_Emperor	successor	Victor_Amadeus_II_of_Sardinia
Clemence_of_Austria	gender	female
Anthony_Woodville_2nd_Earl_Rivers	type	Person
Louis_V_of_France	type	Person
Ramon_Berenguer_III_Count_of_Barcelona	parent	Ramon_Berenguer_II_Count_of_Barcelona
Maria_of_Aragon_Queen_of_Portugal	parent	Isabella_I_of_Castile
Louis_Prince_of_Cond__1530_1569	type	Person
Albert_II_Duke_of_Brunswic_L_neburg	hasSpouse	No
Philip_II_of_Spain	spouse	Mary_I_of_England
John_I_Count_of_Hainaut	parent	Bouchard_IV_of_Avesnes
Beatrice_of_Silesia	parent	Bolko_I_the_Strict
Berthold_II_Count_of_Andechs	hasSpouse	No
Maria_of_Aragon_Queen_of_Portugal	father	Ferdinand_II_of_Aragon
Baldwin_V_Count_of_Hainaut	spouse	Margaret_I_Countess_of_Flanders
Maria_of_Portugal_Duchess_of_Viseu	type	Person
Alice_Holland_Countess_of_Kent	father	Richard_Fitzalan_3rd_Earl_of_Arundel
Philip_the_Bold	parent	John_II_of_France
Joan_Countess_of_Ponthieu	parent	Simon_Count_of_Ponthieu
Francis_I_Holy_Roman_Emperor	mother	_lisabeth_Charlotte_d_Orl_ans
Bianca_Maria_Visconti	spouse	Francesco_I_Sforza
Gaston_Prince_of_Viana	type	Person
